"SubmissionID","Freehand","Highlight","Recording","Text","total.words","auidio.min","audio.words","txt.words"
10312,0,0,5,0,251,1.53333333333333,251,0
10314,4,5,4,12,405,1.96666666666667,323,82
10315,0,0,1,0,268,1.63333333333333,268,0
10316,0,0,0,6,64,0,0,64
10317,0,0,1,0,295,1.8,295,0
10318,0,0,0,7,60,0,0,60
10320,1,0,0,16,160,0,0,160
10321,0,0,0,12,112,0,0,112
10322,0,0,1,7,174,0.783333333333333,128,46
10323,0,0,7,0,385,2.35,385,0
10324,1,0,0,5,119,0,0,119
10325,0,0,0,8,59,0,0,59
10326,0,0,1,0,260,1.58333333333333,260,0
10327,9,0,4,9,339,1.85,303,36
10496,7,0,4,1,296,1.8,295,1
10499,2,0,0,5,7,0,0,7
10605,0,0,5,1,246,1.48333333333333,244,2
10607,2,0,1,10,64,0.283333333333333,46,18
10608,0,1,4,0,385,2.35,385,0
10609,1,1,0,2,14,0,0,14
10610,0,1,2,1,57,0.283333333333333,47,10
10611,0,2,5,0,117,0.716666666666667,117,0
10612,0,2,8,0,759,4.63333333333333,759,0
10614,0,1,2,0,109,0.666666666666667,109,0
10615,0,2,5,0,221,1.35,221,0
10616,0,0,2,0,47,0.283333333333333,47,0
10618,0,1,10,0,1348,8.21666666666667,1348,0
10619,0,2,9,0,849,5.18333333333333,849,0
10620,0,0,15,0,1016,6.2,1016,0
10621,9,17,2,33,781,2.28333333333333,374,407
10622,0,0,9,0,644,3.91666666666667,644,0
10623,0,3,2,0,85,0.516666666666667,85,0
10624,0,1,19,0,1193,7.26666666666667,1193,0
10625,0,1,1,0,11,0.0666666666666667,11,0
10626,0,4,6,0,1098,6.7,1098,0
10627,0,1,23,0,1112,6.78333333333333,1112,0
10628,0,0,19,0,862,5.26666666666667,862,0
10629,4,4,9,13,1676,9.66666666666667,1586,90
10630,0,5,9,0,552,3.36666666666667,552,0
10631,0,2,6,0,1557,9.5,1557,0
10632,3,7,4,0,960,5.85,960,0
10633,0,0,4,0,248,1.51666666666667,248,0
10634,3,6,4,2,1501,9.11666666666667,1496,5
10635,8,14,8,26,1999,10.55,1731,268
10636,3,0,9,7,2440,14.7333333333333,2416,24
10637,0,2,3,1,251,1.51666666666667,249,2
10638,0,1,4,0,218,1.33333333333333,218,0
10639,0,1,1,1,17,0.05,8,9
10640,0,2,4,1,638,3.88333333333333,637,1
10641,0,4,8,1,946,5.76666666666667,945,1
10642,0,0,5,0,265,1.61666666666667,265,0
10643,0,0,19,0,860,5.25,860,0
10645,0,1,5,0,331,2.01666666666667,331,0
10646,0,0,13,0,583,3.55,583,0
10647,0,0,10,0,371,2.26666666666667,371,0
10648,3,12,10,1,2375,14.4833333333333,2374,1
10649,1,4,2,1,97,0.583333333333333,96,1
10650,1,8,6,1,1176,7.16666666666667,1175,1
10651,0,0,17,0,672,4.1,672,0
10654,0,0,13,0,606,3.7,606,0
10655,1,2,2,2,70,0.383333333333333,63,7
10656,0,5,7,1,459,2.78333333333333,457,2
10658,0,0,12,0,691,4.21666666666667,691,0
10659,1,3,7,1,356,2.15,353,3
10661,1,1,14,11,1550,8.9,1461,89
10662,0,9,11,3,803,4.85,795,8
10663,0,1,2,0,46,0.283333333333333,46,0
10664,2,8,5,2,1232,7.5,1230,2
10665,5,2,2,3,44,0.2,32,12
10666,1,1,2,2,121,0.65,106,15
10667,0,1,2,1,79,0.366666666666667,61,18
10669,2,11,6,0,1751,10.6833333333333,1751,0
10670,0,2,10,3,1103,6.65,1091,12
10671,0,5,2,3,62,0.333333333333333,55,7
10672,9,3,14,16,2120,12.1833333333333,1996,124
10673,2,3,6,1,1703,10.3666666666667,1700,3
10674,0,0,2,0,55,0.333333333333333,55,0
10675,0,1,1,1,43,0.216666666666667,36,7
10676,0,0,14,0,487,2.96666666666667,487,0
10678,5,4,16,6,2518,15.2833333333333,2506,12
10679,6,11,0,27,450,0,0,450
10680,4,5,7,0,1676,10.2166666666667,1676,0
10681,0,2,5,0,271,1.65,271,0
10688,0,0,2,0,106,0.65,106,0
10689,5,4,8,18,1629,9.03333333333333,1482,147
10690,2,14,6,0,2320,14.15,2320,0
10692,0,0,0,8,103,0,0,103
10693,4,7,8,2,2376,14.4833333333333,2374,2
10694,2,0,2,7,163,0.766666666666667,126,37
10696,0,0,0,6,52,0,0,52
10707,0,2,11,0,498,3.03333333333333,498,0
10708,0,0,4,0,194,1.18333333333333,194,0
10711,2,4,3,2,120,0.6,99,21
1486,1,1,12,10,1182,6.46666666666667,1060,122
1487,0,0,1,16,362,0.533333333333333,87,275
1488,0,1,7,8,649,3.35,550,99
1489,0,0,10,0,749,4.56666666666667,749,0
1490,0,0,11,0,975,5.95,975,0
1491,9,2,2,14,277,0.233333333333333,38,239
1492,1,0,1,7,186,0.116666666666667,19,167
1493,0,0,6,0,877,5.35,877,0
1494,0,0,24,0,2335,14.2333333333333,2335,0
1495,1,0,2,10,218,0.216666666666667,35,183
1497,0,0,11,4,937,5.46666666666667,897,40
1499,0,0,9,2,596,3.61666666666667,592,4
1500,0,0,12,2,980,5.95,976,4
1501,1,0,4,6,508,1.95,320,188
1503,0,0,9,0,779,4.75,779,0
1504,0,0,6,0,580,3.53333333333333,580,0
1505,0,0,8,14,941,5.1,837,104
1507,5,0,4,22,566,1.41666666666667,231,335
1508,3,0,4,24,635,1.41666666666667,231,404
1509,0,0,7,0,863,5.26666666666667,863,0
1510,0,0,8,0,811,4.95,811,0
1512,0,0,10,0,1371,8.35,1371,0
1513,2,2,14,1,1638,9.96666666666667,1634,4
1515,0,0,11,6,1159,6.75,1108,51
1516,0,0,16,0,940,5.73333333333333,940,0
1517,0,0,8,0,602,3.66666666666667,602,0
1519,1,0,10,4,565,3.35,549,16
1520,4,2,5,24,968,3.4,556,412
1522,0,0,9,0,973,5.93333333333333,973,0
1523,3,0,7,18,734,3.05,499,235
1524,0,0,11,0,1234,7.51666666666667,1234,0
1525,0,0,1,14,341,0.966666666666667,159,182
1526,0,0,9,0,686,4.18333333333333,686,0
1527,0,0,1,11,250,0.116666666666667,19,231
1528,0,0,16,0,1122,6.85,1122,0
1529,4,2,0,19,224,0,0,224
1530,0,0,6,24,809,3.26666666666667,535,274
1531,0,0,9,0,1184,7.21666666666667,1184,0
1532,1,0,2,15,323,0.716666666666667,117,206
1533,2,0,7,19,617,2.41666666666667,394,223
1534,1,0,1,6,99,0.116666666666667,19,80
1535,1,0,9,8,717,3.86666666666667,634,83
1536,0,0,11,4,536,3,494,42
1537,0,0,9,7,556,3.01666666666667,494,62
1538,0,1,4,13,639,2.38333333333333,391,248
1540,0,0,1,12,324,0.6,98,226
1541,1,0,5,12,550,2.23333333333333,366,184
1542,0,0,10,0,652,3.96666666666667,652,0
1543,0,0,5,9,506,2.73333333333333,449,57
1544,5,0,1,12,233,0.116666666666667,19,214
1545,0,0,3,4,339,1.23333333333333,202,137
1546,0,1,1,11,252,0.116666666666667,19,233
1547,0,0,7,0,666,4.06666666666667,666,0
1548,0,0,7,7,735,3.71666666666667,609,126
1549,0,1,7,4,438,2.4,395,43
1550,0,0,1,11,348,0.816666666666667,134,214
1552,0,0,6,0,773,4.7,773,0
1553,0,0,1,11,218,0.683333333333333,112,106
1554,1,0,4,12,409,1.58333333333333,259,150
1555,1,0,7,7,545,2.88333333333333,473,72
1556,0,0,1,15,335,0.616666666666667,101,234
1557,1,0,7,4,467,2.73333333333333,447,20
1558,0,0,4,17,542,1.41666666666667,231,311
1559,0,0,6,0,514,3.13333333333333,514,0
1560,0,0,17,0,1484,9.05,1484,0
1561,2,3,0,15,381,0,0,381
1562,0,0,3,5,434,1.61666666666667,265,169
1563,1,1,1,15,372,0.633333333333333,104,268
1564,3,0,1,12,214,0.116666666666667,19,195
1566,0,4,0,15,341,0,0,341
1567,2,0,3,19,480,0.816666666666667,133,347
1568,0,0,15,0,1644,10.0166666666667,1644,0
1569,0,0,1,16,390,0.766666666666667,126,264
1572,0,0,5,12,591,2.46666666666667,404,187
1573,3,0,1,11,258,0.116666666666667,19,239
1575,0,0,20,0,2140,13.0333333333333,2140,0
1576,0,0,9,0,948,5.78333333333333,948,0
1577,0,0,5,6,332,1.75,287,45
1578,1,0,1,12,230,0.366666666666667,60,170
1579,0,0,5,10,511,2.31666666666667,380,131
1580,0,0,8,7,557,3.05,500,57
1581,0,0,13,0,747,4.56666666666667,747,0
1582,1,0,0,6,85,0,0,85
1584,0,0,18,0,1753,10.6833333333333,1753,0
1586,0,0,8,0,1085,6.61666666666667,1085,0
1587,0,2,5,6,374,2.05,337,37
1588,2,0,6,21,1085,4.48333333333333,734,351
1589,0,0,2,13,311,0.516666666666667,85,226
1590,0,0,6,11,571,3.26666666666667,536,35
1591,0,3,4,4,348,1.85,303,45
1592,3,0,0,10,201,0,0,201
1593,2,0,8,10,657,3.48333333333333,572,85
1595,0,0,1,17,413,0.666666666666667,109,304
1596,0,0,7,0,624,3.8,624,0
1597,0,0,6,4,240,1.4,229,11
1598,0,0,0,10,153,0,0,153
1599,2,0,5,11,552,2.65,435,117
1600,0,0,6,0,439,2.68333333333333,439,0
1601,0,0,10,0,1103,6.73333333333333,1103,0
1602,0,0,14,0,1486,9.06666666666667,1486,0
1603,3,2,7,12,737,3.86666666666667,633,104
1604,0,0,3,5,437,1.76666666666667,290,147
1605,2,0,3,21,522,1.06666666666667,174,348
1606,8,1,6,25,651,2.4,393,258
1608,2,5,7,18,694,2.86666666666667,471,223
1609,4,2,5,24,687,1.81666666666667,297,390
1610,3,0,6,11,521,2.55,419,102
1611,0,0,1,14,378,0.633333333333333,104,274
1612,0,0,10,0,1166,7.11666666666667,1166,0
1613,2,0,8,11,630,3.18333333333333,522,108
1645,1,1,2,19,407,0.716666666666667,117,290
1649,0,0,9,5,507,2.88333333333333,473,34
1651,3,0,0,13,229,0,0,229
1652,0,0,4,17,458,1.16666666666667,190,268
1654,4,0,0,14,223,0,0,223
1655,8,2,4,22,477,1.16666666666667,190,287
1656,0,3,0,13,200,0,0,200
1657,0,0,15,0,1198,7.3,1198,0
1658,1,6,10,8,979,5.28333333333333,865,114
1659,1,0,10,8,1118,5.85,959,159
1660,6,14,8,21,1078,5.2,853,225
1661,9,2,5,24,600,1.76666666666667,288,312
1662,0,0,6,16,523,2.38333333333333,391,132
1663,0,3,0,14,260,0,0,260
1664,0,4,0,11,191,0,0,191
1665,0,0,8,0,671,4.1,671,0
1666,0,0,9,0,694,4.23333333333333,694,0
1667,0,0,8,0,804,4.9,804,0
1668,0,0,3,1,297,1.75,287,10
1670,1,2,10,5,540,2.36666666666667,386,154
1671,1,0,1,11,267,0.116666666666667,19,248
1672,1,0,4,19,510,1.16666666666667,190,320
1673,0,0,5,6,343,1.93333333333333,317,26
1674,0,0,8,0,488,2.96666666666667,488,0
1675,0,0,2,6,335,1.41666666666667,232,103
1676,5,1,5,21,587,1.76666666666667,288,299
1679,4,12,15,7,1319,7.95,1304,15
1680,0,0,0,10,278,0,0,278
1681,0,0,2,1,120,0.616666666666667,101,19
1682,7,0,5,17,500,1.73333333333333,283,217
1683,0,4,7,6,595,3.3,542,53
1684,0,0,7,2,582,3.45,567,15
1685,5,0,0,11,190,0,0,190
1686,0,0,15,0,890,5.43333333333333,890,0
1687,9,14,21,9,2391,14.2333333333333,2335,56
1688,0,0,1,9,183,0.166666666666667,27,156
1689,0,2,0,15,344,0,0,344
1690,0,0,2,5,222,1.2,197,25
1691,0,4,0,13,348,0,0,348
1692,0,0,2,4,485,2.16666666666667,355,130
1693,0,2,8,3,645,3.86666666666667,634,11
1695,0,0,1,10,174,0.166666666666667,27,147
1698,0,0,2,4,299,1.43333333333333,235,64
1699,0,0,2,7,223,0.883333333333333,145,78
1700,0,0,5,0,329,2,329,0
1702,0,0,11,3,674,4.06666666666667,668,6
1704,0,0,16,0,1230,7.5,1230,0
1705,1,0,4,16,382,1.16666666666667,190,192
1706,0,0,1,6,163,0.416666666666667,68,95
1707,0,0,2,17,260,0.733333333333333,121,139
1708,0,0,13,2,837,4.33333333333333,710,127
1709,0,0,1,11,245,0.116666666666667,19,226
1711,2,1,11,1,715,3.8,623,92
1712,1,0,1,10,115,0.316666666666667,52,63
1713,0,1,8,2,574,3.43333333333333,562,12
1715,1,0,1,10,161,0.633333333333333,104,57
1717,10,14,12,11,1072,5.2,852,220
1718,0,0,7,0,714,4.35,714,0
1719,6,5,9,7,1305,6.66666666666667,1093,212
1720,1,9,4,15,949,4.55,747,202
1722,0,0,8,0,699,4.26666666666667,699,0
1723,0,0,8,4,543,3.21666666666667,527,16
1724,1,1,7,4,425,2.36666666666667,389,36
1725,1,2,0,12,372,0,0,372
1726,0,0,6,0,535,3.26666666666667,535,0
1727,0,2,11,1,855,5.2,853,2
1729,5,1,3,23,436,0.8,130,306
1730,0,0,9,0,645,3.93333333333333,645,0
1731,0,0,11,0,1005,6.13333333333333,1005,0
1732,0,0,4,0,452,2.75,452,0
1733,2,0,10,2,569,3.23333333333333,530,39
1734,1,0,2,18,409,0.716666666666667,117,292
1735,0,0,1,11,178,0.166666666666667,27,151
1736,0,0,5,10,528,2.61666666666667,430,98
1737,2,0,4,17,436,1.16666666666667,190,246
1738,1,0,3,14,379,1.06666666666667,174,205
1739,1,1,0,12,210,0,0,210
1740,6,1,4,23,477,1.16666666666667,190,287
1742,0,1,0,11,231,0,0,231
1743,0,0,9,0,1192,7.28333333333333,1192,0
1744,3,4,4,13,638,2.76666666666667,454,184
1745,2,0,6,12,826,4,654,172
1746,0,0,13,0,1083,6.6,1083,0
1747,0,0,1,6,163,0.733333333333333,120,43
1748,0,0,13,3,830,4.23333333333333,695,135
1749,0,0,11,3,708,4.13333333333333,678,30
1750,0,0,8,6,581,3.21666666666667,529,52
1751,0,0,9,0,666,4.06666666666667,666,0
1752,2,4,9,8,995,5.36666666666667,880,115
1753,0,0,15,0,1648,10.05,1648,0
1754,0,0,8,4,650,2.98333333333333,490,160
1755,0,0,7,8,531,2.8,459,72
1756,0,0,10,3,731,3.51666666666667,576,155
1757,0,1,9,7,775,4.45,728,47
1758,0,0,9,0,607,3.7,607,0
1759,4,0,0,13,169,0,0,169
1760,0,3,0,20,157,0,0,157
1761,1,2,0,12,264,0,0,264
1762,0,3,12,1,947,5.73333333333333,941,6
1763,1,0,13,2,666,4.01666666666667,658,8
1764,7,6,4,17,668,2.81666666666667,462,206
1765,0,3,1,13,309,0.566666666666667,93,216
1766,0,0,5,0,565,3.45,565,0
1767,8,11,8,9,1284,7.1,1165,119
1768,2,0,4,14,773,3.3,540,233
1769,0,4,2,10,495,1.36666666666667,224,271
1770,0,4,9,3,727,4.23333333333333,696,31
1771,0,0,3,11,352,1.25,205,147
1772,0,0,6,0,683,4.16666666666667,683,0
1773,0,0,7,0,996,6.06666666666667,996,0
1774,0,2,6,1,505,2.98333333333333,490,15
1775,0,0,2,4,318,1.66666666666667,273,45
1776,0,5,4,8,177,0.683333333333333,112,65
1777,3,1,3,23,654,1.51666666666667,248,406
1779,3,3,3,19,296,0.983333333333333,162,134
1780,1,0,13,3,834,5.01666666666667,822,12
1781,0,2,1,10,306,0.566666666666667,93,213
1782,0,0,8,0,869,5.3,869,0
1783,3,0,1,16,314,0.116666666666667,19,295
1784,0,4,0,15,423,0,0,423
1785,0,0,10,7,616,2.58333333333333,423,193
1786,0,0,11,1,699,4.25,696,3
1788,3,6,5,10,849,4.53333333333333,743,106
1789,0,0,11,5,672,3.95,648,24
1790,0,0,0,10,279,0,0,279
1791,0,1,7,2,475,2.85,468,7
1793,18,12,4,18,1116,5.1,837,279
1795,1,0,3,21,510,0.816666666666667,133,377
1796,0,0,9,0,770,4.7,770,0
1798,0,3,7,2,416,2.41666666666667,396,20
1800,0,0,4,0,264,1.61666666666667,264,0
1801,1,0,1,16,258,0.366666666666667,60,198
1802,0,0,1,7,225,0.566666666666667,93,132
1803,1,4,7,8,744,3.93333333333333,645,99
1804,0,0,9,0,949,5.78333333333333,949,0
1805,0,0,1,12,167,0.166666666666667,27,140
1806,15,19,7,14,1614,8.11666666666667,1331,283
1808,0,1,0,11,265,0,0,265
1811,0,0,9,0,1057,6.45,1057,0
1812,2,0,4,13,375,1.16666666666667,190,185
1814,1,0,5,18,571,1.76666666666667,288,283
1816,0,0,4,4,533,2.66666666666667,437,96
1817,6,0,6,20,674,2.36666666666667,386,288
1818,0,0,8,0,583,3.55,583,0
1819,5,0,0,12,190,0,0,190
1820,0,2,4,8,569,2.58333333333333,424,145
1822,1,3,3,7,175,0.683333333333333,112,63
1823,0,5,0,14,274,0,0,274
1824,7,0,0,14,220,0,0,220
1825,1,1,0,7,273,0,0,273
1826,0,0,1,11,174,0.166666666666667,27,147
1827,0,0,6,8,557,2.78333333333333,457,100
1828,1,0,6,4,602,2.7,442,160
1829,0,0,7,1,410,2.48333333333333,409,1
1830,0,0,2,4,316,1.46666666666667,240,76
1831,0,0,7,0,513,3.13333333333333,513,0
1832,0,0,3,15,410,1.06666666666667,174,236
1833,0,0,9,1,711,4.33333333333333,710,1
1835,5,0,5,12,797,3.65,597,200
1836,8,4,1,25,346,0.35,57,289
1837,2,0,15,2,907,4.76666666666667,780,127
1838,2,0,7,10,636,3.3,541,95
1839,0,0,6,0,719,4.38333333333333,719,0
1840,2,0,1,15,302,0.116666666666667,19,283
1841,1,2,3,7,164,0.616666666666667,101,63
1842,1,0,9,3,723,3.61666666666667,593,130
1844,0,0,1,9,241,0.166666666666667,27,214
1845,7,0,0,12,198,0,0,198
1846,0,0,8,0,858,5.23333333333333,858,0
1847,0,1,2,9,502,1.4,230,272
1849,0,0,8,0,565,3.45,565,0
1850,0,0,7,0,708,4.31666666666667,708,0
1852,0,0,2,7,440,1.8,295,145
1854,0,0,6,5,390,2.23333333333333,367,23
1855,0,3,10,2,758,4.6,753,5
1856,1,7,0,19,206,0,0,206
1857,0,5,3,9,665,2.43333333333333,400,265
1858,2,0,5,14,773,3.4,556,217
1859,0,0,8,5,506,2.9,475,31
1860,0,0,12,0,599,3.66666666666667,599,0
1861,0,0,5,0,640,3.9,640,0
1862,0,0,7,6,536,3.01666666666667,495,41
1863,1,0,3,18,413,1.06666666666667,174,239
1864,0,0,7,2,624,3.03333333333333,497,127
1865,2,4,3,7,178,0.7,115,63
1867,0,0,2,8,397,1.38333333333333,227,170
1868,0,0,2,0,134,0.816666666666667,134,0
1869,0,3,3,7,148,0.533333333333333,88,60
1870,15,13,9,15,1189,5.86666666666667,959,230
1871,0,2,9,1,677,4.08333333333333,669,8
1872,0,0,3,3,148,0.733333333333333,120,28
1873,0,3,5,5,289,1.58333333333333,259,30
1874,0,0,7,7,529,2.81666666666667,462,67
1875,0,1,0,11,359,0,0,359
1876,0,3,4,7,164,0.566666666666667,94,70
1878,0,1,3,6,223,1.15,189,34
1879,5,0,7,5,656,3.01666666666667,495,161
1880,0,2,8,2,600,3.56666666666667,584,16
1881,5,0,0,13,174,0,0,174
1882,1,0,1,15,302,0.116666666666667,19,283
1883,1,4,5,10,451,2.16666666666667,355,96
1884,2,0,9,3,551,3.21666666666667,529,22
1885,0,0,9,3,529,3.13333333333333,514,15
1886,2,0,2,6,297,1.18333333333333,194,103
1887,1,0,1,10,185,0.116666666666667,19,166
1888,0,0,10,0,687,4.18333333333333,687,0
1889,1,0,1,12,237,0.466666666666667,77,160
1890,3,0,0,13,189,0,0,189
1891,0,0,8,0,590,3.6,590,0
1892,0,6,1,12,698,1.91666666666667,314,384
1893,0,0,9,0,1163,7.1,1163,0
1894,0,1,2,7,397,1.35,222,175
1896,0,0,7,0,673,4.1,673,0
1897,4,0,4,21,480,1.16666666666667,190,290
1898,0,6,0,15,302,0,0,302
1899,1,1,0,10,220,0,0,220
1901,0,0,1,12,195,0.166666666666667,27,168
1903,0,2,4,5,123,0.566666666666667,93,30
1904,0,1,0,24,217,0,0,217
1905,1,0,7,10,611,2.91666666666667,479,132
1906,0,0,8,0,659,4.01666666666667,659,0
1907,2,0,9,7,624,3.66666666666667,600,24
1908,0,0,12,2,636,3.83333333333333,629,7
1909,0,0,10,4,625,3.75,614,11
1910,0,1,0,8,235,0,0,235
1912,0,4,0,18,343,0,0,343
1913,0,0,9,0,1066,6.5,1066,0
1914,18,15,8,9,707,3.46666666666667,568,139
1915,1,2,0,20,324,0,0,324
1916,1,0,2,5,354,1.65,270,84
1917,0,0,1,15,293,0.833333333333333,137,156
1918,1,0,6,1,393,2.38333333333333,390,3
1919,8,6,11,7,1103,6.45,1058,45
1921,1,0,1,12,266,0.166666666666667,27,239
1922,4,0,1,9,171,0.116666666666667,19,152
1924,0,0,10,4,641,3.75,616,25
1925,0,2,2,11,442,1.4,230,212
1926,2,1,5,16,524,1.76666666666667,288,236
1927,3,1,1,22,332,0.35,57,275
1928,7,1,4,24,524,1.41666666666667,231,293
1929,0,0,11,0,1171,7.13333333333333,1171,0
1930,0,0,14,0,1877,11.45,1877,0
1931,0,0,6,10,650,3.01666666666667,496,154
1932,0,0,16,0,947,5.76666666666667,947,0
1933,0,0,1,15,291,0.483333333333333,79,212
1934,2,0,2,20,448,0.716666666666667,117,331
1936,3,0,4,20,487,1.16666666666667,190,297
1937,0,0,10,4,719,4.25,698,21
1938,0,0,9,0,812,4.95,812,0
1939,0,0,11,0,595,3.63333333333333,595,0
1940,0,0,5,8,607,2.61666666666667,430,177
1941,3,0,1,18,288,0.833333333333333,137,151
1942,0,0,9,7,850,4.88333333333333,801,49
1943,0,0,9,0,765,4.66666666666667,765,0
1945,0,0,1,14,218,0.4,66,152
1946,0,0,10,5,813,4.71666666666667,775,38
1948,5,1,3,17,336,0.816666666666667,133,203
1950,6,1,4,17,428,1.16666666666667,190,238
1951,0,0,9,1,590,3.58333333333333,587,3
1952,3,3,0,19,155,0,0,155
1953,6,7,12,2,1241,7.2,1182,59
1954,0,0,10,0,889,5.41666666666667,889,0
1955,1,0,9,2,517,3.13333333333333,513,4
1956,0,0,13,0,2079,12.6666666666667,2079,0
1958,0,0,13,0,1780,10.85,1780,0
1959,0,0,11,0,1924,11.7333333333333,1924,0
1961,17,18,15,13,1766,9.81666666666667,1609,157
1962,2,0,7,8,629,3.46666666666667,569,60
1963,0,0,8,0,557,3.4,557,0
1964,0,0,11,0,2461,15,2461,0
1966,0,0,3,11,404,0.666666666666667,109,295
1967,0,0,13,3,780,4.66666666666667,766,14
1969,18,14,7,13,1043,5.75,943,100
1970,1,0,9,6,609,3.31666666666667,544,65
1972,4,1,0,17,189,0,0,189
1973,1,0,11,2,766,4.56666666666667,749,17
1974,5,4,0,24,243,0,0,243
1975,0,0,6,9,532,2.75,452,80
1976,0,0,13,0,2338,14.25,2338,0
1977,0,0,16,0,2929,17.85,2929,0
1978,1,0,7,8,525,2.8,459,66
1980,0,0,12,5,888,5.18333333333333,851,37
1981,0,0,13,0,3060,18.6666666666667,3060,0
1982,0,0,5,0,842,5.13333333333333,842,0
1983,7,1,5,18,461,1.26666666666667,206,255
1984,5,1,4,17,399,1.16666666666667,190,209
1985,0,0,1,7,154,0.166666666666667,27,127
1986,0,1,1,16,394,0.616666666666667,101,293
1987,2,0,5,9,734,3.61666666666667,594,140
1988,3,1,5,21,838,3.4,556,282
1989,0,0,1,14,334,0.416666666666667,68,266
1990,0,0,10,0,1163,7.08333333333333,1163,0
1991,1,0,7,9,563,3.05,500,63
1994,0,0,6,9,758,3.78333333333333,620,138
1995,0,0,5,7,434,2.38333333333333,391,43
1996,1,0,6,6,633,3.68333333333333,604,29
1997,0,0,8,0,943,5.75,943,0
1998,2,1,0,20,229,0,0,229
1999,10,15,6,10,749,3.56666666666667,585,164
2000,1,0,7,6,638,3.56666666666667,585,53
2001,0,0,14,1,847,5.15,845,2
2002,0,0,9,0,694,4.23333333333333,694,0
2003,0,0,5,12,447,1.51666666666667,247,200
2004,0,0,0,17,154,0,0,154
2005,0,1,7,1,676,4.1,673,3
2007,0,0,9,0,886,5.4,886,0
2008,0,1,0,18,166,0,0,166
2009,1,0,5,10,700,3.26666666666667,536,164
2010,0,0,0,14,116,0,0,116
2013,4,0,4,20,460,1.16666666666667,190,270
2014,12,10,7,14,627,2.85,467,160
2015,0,0,12,0,997,6.08333333333333,997,0
2016,13,12,7,13,760,3.36666666666667,552,208
2017,11,14,6,12,496,2.3,377,119
2019,0,0,8,0,681,4.15,681,0
2020,0,0,6,8,720,3.85,632,88
2021,0,0,12,0,1157,7.05,1157,0
2023,0,0,6,0,611,3.71666666666667,611,0
2024,0,0,8,5,619,3.55,583,36
2025,1,0,0,10,94,0,0,94
2026,1,0,4,10,730,3.11666666666667,511,219
2027,0,0,3,17,471,0.85,139,332
2028,0,1,1,14,217,0.166666666666667,27,190
2029,0,0,11,1,671,4.06666666666667,668,3
2030,0,1,1,15,408,0.733333333333333,120,288
2032,0,0,2,9,262,0.783333333333333,129,133
2033,2,6,11,4,1293,7.13333333333333,1169,124
2034,0,2,9,3,692,4.15,680,12
2035,7,7,11,19,795,3.4,558,237
2037,1,1,5,21,570,1.26666666666667,206,364
2038,0,0,9,0,554,3.38333333333333,554,0
2039,0,1,4,15,426,1.16666666666667,190,236
2040,6,2,2,18,397,0.716666666666667,117,280
2042,0,2,6,19,636,1.86666666666667,304,332
2043,3,2,3,6,151,0.566666666666667,92,59
2044,5,0,0,15,96,0,0,96
2046,0,0,9,0,552,3.36666666666667,552,0
2047,1,0,4,16,459,1.16666666666667,190,269
2050,0,3,2,9,343,0.9,148,195
2051,0,2,0,12,229,0,0,229
2053,0,2,2,9,437,1.2,197,240
2054,0,0,6,0,398,2.43333333333333,398,0
2055,0,0,7,0,710,4.33333333333333,710,0
2056,0,0,13,0,1468,8.95,1468,0
2058,3,1,4,18,401,0.916666666666667,149,252
2059,4,8,19,2,1643,9.93333333333333,1628,15
2060,5,7,14,4,1228,6.96666666666667,1142,86
2061,0,0,0,10,245,0,0,245
2063,0,1,2,8,410,1.2,197,213
2064,0,1,2,7,423,1.4,230,193
2065,0,0,7,0,822,5.01666666666667,822,0
2066,4,5,4,18,470,1.06666666666667,176,294
2067,2,4,16,4,1404,8.23333333333333,1351,53
2068,1,2,11,2,1201,7.2,1182,19
2069,0,6,7,16,563,2.11666666666667,347,216
2070,0,2,10,1,999,6.06666666666667,996,3
2071,3,0,4,15,440,1.16666666666667,190,250
2072,0,0,6,4,593,3.33333333333333,546,47
2073,0,3,5,5,582,2.85,467,115
2074,1,1,4,6,231,1.2,197,34
2075,0,0,9,0,475,2.9,475,0
2076,0,0,7,6,597,3.48333333333333,572,25
2077,0,0,9,0,1241,7.56666666666667,1241,0
2080,0,0,9,0,594,3.61666666666667,594,0
2082,3,0,0,15,157,0,0,157
2083,1,3,4,17,423,1.16666666666667,190,233
2084,2,0,12,2,795,4.83333333333333,792,3
2085,1,3,3,9,161,0.6,98,63
2087,0,1,7,1,632,3.85,631,1
2088,0,3,0,12,300,0,0,300
2089,0,0,1,14,377,0.45,74,303
2090,2,5,4,14,437,1.21666666666667,199,238
2091,4,0,0,12,103,0,0,103
2092,0,0,8,0,716,4.36666666666667,716,0
2093,0,3,3,7,181,0.816666666666667,134,47
2094,0,0,7,0,472,2.88333333333333,472,0
2095,1,0,0,14,205,0,0,205
2096,1,4,4,14,301,0.916666666666667,150,151
2097,3,1,0,11,123,0,0,123
2098,0,0,8,5,775,4.13333333333333,678,97
2099,0,1,7,1,589,3.55,581,8
2100,0,0,9,0,700,4.26666666666667,700,0
2101,0,0,8,0,653,3.98333333333333,653,0
2102,0,2,1,10,358,0.516666666666667,85,273
2103,0,0,0,13,243,0,0,243
2105,3,0,3,17,464,1.06666666666667,174,290
2106,0,0,1,13,308,0.433333333333333,71,237
2107,0,0,0,10,231,0,0,231
2109,0,0,2,7,387,0.966666666666667,158,229
2110,0,0,8,0,615,3.75,615,0
2112,8,8,8,22,890,3.25,533,357
2113,0,0,7,2,592,3.51666666666667,575,17
2114,0,1,4,6,488,2.2,361,127
2115,0,0,7,0,612,3.73333333333333,612,0
2116,0,1,5,4,483,2.81666666666667,462,21
2117,0,0,5,5,482,2.68333333333333,440,42
2118,1,1,3,6,219,1.03333333333333,169,50
2119,1,0,14,0,1135,6.91666666666667,1135,0
2120,0,2,2,8,167,0.516666666666667,85,82
2121,0,0,7,0,519,3.16666666666667,519,0
2122,1,0,0,18,140,0,0,140
2123,0,1,5,15,560,1.76666666666667,288,272
2124,0,0,9,0,689,4.2,689,0
2126,0,3,0,11,302,0,0,302
2128,2,4,3,7,218,1.08333333333333,178,40
2129,0,2,1,10,359,0.516666666666667,85,274
2130,2,2,0,13,202,0,0,202
2131,3,1,0,12,269,0,0,269
2132,0,0,10,0,957,5.83333333333333,957,0
2133,0,0,9,0,676,4.11666666666667,676,0
2134,1,0,2,10,285,0.783333333333333,129,156
2135,2,0,3,18,359,0.816666666666667,133,226
2136,0,3,5,17,488,1.46666666666667,240,248
2137,1,1,15,1,1382,8.16666666666667,1339,43
2138,0,0,12,0,872,5.31666666666667,872,0
2139,0,0,7,0,563,3.43333333333333,563,0
2140,0,0,4,10,492,2.11666666666667,347,145
2141,0,0,8,0,836,5.1,836,0
2142,3,5,13,4,1310,7.11666666666667,1167,143
2143,2,4,10,1,801,4.86666666666667,797,4
2144,1,0,1,5,168,0.333333333333333,55,113
2145,0,0,8,0,702,4.28333333333333,702,0
2146,0,0,7,12,561,2.15,352,209
2147,0,0,10,0,658,4.01666666666667,658,0
2149,0,0,10,0,773,4.71666666666667,773,0
2151,2,1,3,7,174,0.683333333333333,112,62
2152,0,0,6,0,785,4.78333333333333,785,0
2154,0,0,7,0,570,3.46666666666667,570,0
2155,0,1,6,3,565,3.08333333333333,506,59
2156,3,0,2,13,332,0.466666666666667,76,256
2158,0,0,9,0,682,4.16666666666667,682,0
2159,0,0,9,0,612,3.73333333333333,612,0
2160,5,2,8,16,625,2.36666666666667,388,237
2161,0,0,6,11,509,1.88333333333333,308,201
2162,2,4,8,12,579,2.36666666666667,388,191
2163,0,0,0,14,94,0,0,94
2164,1,0,7,16,545,1.98333333333333,325,220
2165,2,5,9,16,687,2.5,410,277
2167,0,1,2,9,171,0.55,90,81
2168,0,0,7,0,542,3.3,542,0
2169,0,1,1,9,413,0.8,131,282
2170,0,0,7,0,667,4.06666666666667,667,0
2171,0,0,7,0,598,3.65,598,0
2172,1,0,1,5,200,0.533333333333333,87,113
2173,0,1,8,2,761,4.48333333333333,734,27
2175,0,0,12,4,708,4.13333333333333,679,29
2176,0,0,12,3,723,4.28333333333333,701,22
2179,2,0,0,14,257,0,0,257
2182,0,0,9,0,735,4.48333333333333,735,0
2183,0,2,11,2,1115,6.13333333333333,1006,109
2184,0,0,1,9,232,0.166666666666667,27,205
2185,12,0,0,18,306,0,0,306
2186,0,2,4,16,468,1.26666666666667,207,261
2187,0,1,0,9,246,0,0,246
2188,0,0,6,3,396,2.28333333333333,375,21
2189,0,1,1,8,331,0.516666666666667,85,246
2190,0,0,6,0,374,2.28333333333333,374,0
2191,5,1,4,20,461,1.16666666666667,190,271
2193,0,0,1,13,174,0.166666666666667,27,147
2195,4,0,3,16,362,0.816666666666667,133,229
2196,0,0,7,0,477,2.9,477,0
2197,0,0,9,0,531,3.23333333333333,531,0
2198,1,1,3,7,219,1.1,181,38
2199,0,0,1,16,293,0.166666666666667,27,266
2200,0,0,5,3,461,2.65,435,26
2202,0,0,0,11,204,0,0,204
2203,0,0,8,1,632,3.83333333333333,629,3
2204,0,0,6,4,524,2.75,451,73
2205,0,2,6,10,475,1.73333333333333,284,191
2206,1,0,0,15,130,0,0,130
2207,4,0,0,15,265,0,0,265
2208,0,0,7,3,576,3.45,566,10
2209,0,0,1,9,185,0.166666666666667,27,158
2211,1,1,4,19,512,1.16666666666667,190,322
2212,0,4,0,14,312,0,0,312
2214,0,0,5,2,263,1.55,254,9
2215,2,2,4,19,492,1.16666666666667,190,302
2216,0,0,1,7,201,0.166666666666667,27,174
2217,0,0,1,11,189,0.166666666666667,27,162
2218,0,0,4,13,402,1.11666666666667,183,219
2219,1,0,1,21,376,0.116666666666667,19,357
2220,4,0,0,16,274,0,0,274
2221,0,0,6,0,350,2.13333333333333,350,0
2222,0,0,4,15,464,1.16666666666667,190,274
2223,3,0,5,15,539,1.76666666666667,288,251
2224,0,0,8,3,677,4,657,20
2226,3,0,1,13,279,0.116666666666667,19,260
2227,4,0,0,12,227,0,0,227
2228,0,0,6,4,442,2.61666666666667,429,13
2229,0,0,7,5,599,3.48333333333333,571,28
2231,2,1,0,15,195,0,0,195
2232,0,0,6,2,297,1.8,295,2
2233,0,0,12,2,656,3.96666666666667,651,5
2234,0,0,11,3,719,4.21666666666667,692,27
2235,0,0,1,11,208,0.166666666666667,27,181
2237,2,2,0,13,237,0,0,237
2238,2,4,17,1,1233,7.25,1190,43
2239,0,0,0,14,117,0,0,117
2240,1,2,17,2,1454,8.6,1409,45
2241,0,1,3,6,499,2.33333333333333,382,117
2242,0,0,7,0,331,2.01666666666667,331,0
2243,0,0,8,0,517,3.15,517,0
2244,0,0,5,2,389,2.33333333333333,382,7
2245,0,0,12,2,592,3.58333333333333,587,5
2247,0,0,11,2,663,4,657,6
2248,2,1,1,14,275,0.1,16,259
2249,0,0,0,1,3,0,0,3
2250,0,0,8,0,565,3.45,565,0
2251,3,1,4,18,412,1.16666666666667,190,222
2252,0,0,9,1,474,2.88333333333333,473,1
2253,0,0,9,2,583,3.51666666666667,578,5
2254,1,0,4,14,416,1.16666666666667,190,226
2256,0,0,8,0,777,4.73333333333333,777,0
2258,10,12,0,25,347,0,0,347
2260,0,0,9,0,397,2.41666666666667,397,0
2261,0,1,4,2,366,2.16666666666667,355,11
2262,2,0,0,9,197,0,0,197
2264,3,0,0,12,268,0,0,268
2267,0,0,1,11,112,0.166666666666667,27,85
2268,3,1,0,16,234,0,0,234
2270,0,0,6,14,523,1.76666666666667,289,234
2271,0,7,2,19,366,0.483333333333333,79,287
2272,5,1,0,15,244,0,0,244
2273,0,0,4,4,393,2.25,370,23
2275,2,1,5,17,541,1.76666666666667,288,253
2276,0,0,6,12,515,1.86666666666667,306,209
2277,0,0,3,0,208,1.26666666666667,208,0
2278,0,0,1,12,226,0.166666666666667,27,199
2279,0,0,6,9,467,1.76666666666667,289,178
2280,0,0,1,13,230,0.166666666666667,27,203
2282,0,0,1,12,221,0.166666666666667,27,194
2283,0,0,4,3,301,1.73333333333333,284,17
2284,0,0,0,9,70,0,0,70
2285,0,0,1,8,154,0.166666666666667,27,127
2286,0,0,8,1,348,2.1,345,3
2287,0,1,2,9,376,1.15,188,188
2288,1,0,0,10,177,0,0,177
2289,0,0,6,0,358,2.18333333333333,358,0
2290,0,0,6,15,556,1.76666666666667,289,267
2291,0,0,8,0,602,3.66666666666667,602,0
2292,0,0,9,6,689,3.78333333333333,620,69
2293,0,0,9,0,627,3.81666666666667,627,0
2294,4,1,0,13,249,0,0,249
2295,1,0,0,11,86,0,0,86
2296,0,0,1,11,432,0.916666666666667,150,282
2297,1,0,0,10,180,0,0,180
2298,2,0,4,17,491,1.16666666666667,190,301
2299,0,0,7,0,464,2.83333333333333,464,0
2300,2,0,1,14,226,0.116666666666667,19,207
2301,0,3,2,10,444,1.65,270,174
2302,6,1,3,21,442,0.816666666666667,133,309
2303,0,0,1,11,235,0.166666666666667,27,208
2304,0,0,0,9,266,0,0,266
2306,0,0,5,0,398,2.43333333333333,398,0
2307,4,1,7,15,461,1.83333333333333,300,161
2309,7,0,2,18,509,1.8,296,213
2310,0,0,1,13,316,0.433333333333333,71,245
2311,0,0,1,12,296,0.233333333333333,38,258
2316,0,0,9,0,544,3.31666666666667,544,0
2317,1,1,14,1,2118,12.7,2082,36
2318,6,3,1,17,384,0.716666666666667,118,266
2320,0,0,13,0,585,3.56666666666667,585,0
2322,0,0,1,9,216,0.166666666666667,27,189
2323,2,0,1,15,241,0.116666666666667,19,222
2324,3,0,11,4,839,4.98333333333333,815,24
2325,1,0,6,7,814,4.55,745,69
2326,3,1,7,9,819,4.53333333333333,745,74
2327,1,0,8,14,431,2.08333333333333,341,90
2328,1,9,12,0,1394,8.5,1394,0
2332,4,0,7,13,860,4.5,739,121
2333,9,1,8,3,643,3.83333333333333,629,14
2334,0,0,12,0,779,4.75,779,0
2335,5,2,2,20,644,2.18333333333333,358,286
2336,0,0,8,0,449,2.73333333333333,449,0
2337,3,0,4,15,953,4.68333333333333,768,185
2339,0,7,3,9,271,0.6,98,173
2340,0,0,11,0,884,5.38333333333333,884,0
2341,0,3,3,7,227,0.45,74,153
2348,0,0,2,8,489,1.81666666666667,298,191
2349,0,0,1,10,341,0.366666666666667,60,281
2350,0,0,3,6,676,2.6,427,249
2351,0,1,4,5,316,1.65,271,45
2352,0,0,7,0,505,3.08333333333333,505,0
2353,0,0,1,3,84,0.416666666666667,68,16
2354,9,22,7,19,612,2.7,443,169
2355,1,0,9,8,1725,10.3833333333333,1704,21
2356,0,4,4,3,444,2.6,427,17
2357,1,2,11,2,1026,6.18333333333333,1014,12
2358,0,0,10,0,727,4.43333333333333,727,0
2359,0,0,11,0,1195,7.28333333333333,1195,0
2360,7,1,1,19,391,0.85,139,252
2361,0,0,6,0,534,3.26666666666667,534,0
2362,0,3,9,4,1896,11.3,1853,43
2363,0,3,9,1,1571,9.58333333333333,1570,1
2364,0,0,5,0,276,1.68333333333333,276,0
2366,0,0,3,11,319,1.46666666666667,240,79
2367,4,0,7,4,524,2.93333333333333,481,43
2368,0,0,6,0,391,2.38333333333333,391,0
2369,0,0,3,0,85,0.516666666666667,85,0
2370,0,3,5,2,477,2.76666666666667,453,24
2371,0,0,7,3,553,3.35,548,5
2372,0,0,4,0,341,2.08333333333333,341,0
2373,0,0,7,8,475,2.83333333333333,464,11
2374,2,1,8,3,220,1.26666666666667,208,12
2375,1,1,1,14,351,0.716666666666667,118,233
2376,5,0,7,0,599,3.65,599,0
2378,2,0,9,3,546,3.15,517,29
2379,2,0,4,6,292,1.2,197,95
2380,3,0,6,5,476,2.58333333333333,424,52
2381,0,0,14,0,1492,9.1,1492,0
2383,1,0,12,3,604,3.43333333333333,564,40
2384,3,1,10,8,410,2.33333333333333,382,28
2385,0,1,8,1,1246,7.46666666666667,1225,21
2386,0,1,4,5,429,2.33333333333333,382,47
2388,0,0,5,0,474,2.88333333333333,474,0
2389,0,0,7,0,781,4.76666666666667,781,0
2390,9,2,2,17,302,1.2,197,105
2391,0,1,7,0,574,3.5,574,0
2392,0,0,2,7,91,0.433333333333333,71,20
2393,0,0,8,0,631,3.85,631,0
2395,0,0,2,14,480,0.533333333333333,88,392
2396,4,1,3,14,895,4.4,722,173
2397,1,0,9,6,1962,11.85,1944,18
2398,0,6,12,2,1503,9.1,1493,10
2399,0,1,2,3,189,0.95,156,33
2400,0,3,12,1,1289,7.86666666666667,1288,1
2401,0,3,6,3,435,2.5,410,25
2402,0,1,7,5,624,3.55,581,43
2403,0,0,1,13,401,0.966666666666667,159,242
2404,0,3,13,1,1068,6.5,1066,2
2405,0,1,10,0,582,3.55,582,0
2406,1,0,9,0,732,4.46666666666667,732,0
2407,0,0,6,10,758,3.95,648,110
2408,3,1,1,13,316,0.85,139,177
2409,0,0,4,0,391,2.38333333333333,391,0
2410,0,1,12,1,1417,8.56666666666667,1405,12
2411,1,0,10,3,1520,9.15,1502,18
2412,0,0,10,0,829,5.05,829,0
2413,4,8,16,0,2242,13.6666666666667,2242,0
2414,0,0,6,0,751,4.58333333333333,751,0
2415,2,8,3,10,329,1.43333333333333,235,94
2416,3,1,4,12,544,2.53333333333333,415,129
2418,0,0,5,0,664,4.05,664,0
2419,2,2,7,2,182,1.1,180,2
2420,6,0,10,4,385,2.15,353,32
2421,0,0,1,4,249,0.883333333333333,145,104
2422,1,0,6,11,770,4,657,113
2423,1,0,10,1,607,3.68333333333333,606,1
2424,0,0,9,0,583,3.55,583,0
2425,0,0,1,8,216,0.2,33,183
2426,0,0,7,7,663,3.85,633,30
2427,6,1,10,6,308,1.7,280,28
2429,11,21,19,9,1840,10.9833333333333,1801,39
2430,0,0,10,0,553,3.36666666666667,553,0
2431,0,0,7,6,631,3.55,581,50
2432,6,0,3,12,461,1.68333333333333,276,185
2433,0,2,1,2,113,0.5,82,31
2435,3,0,13,3,692,4.05,665,27
2436,0,3,1,7,173,0.483333333333333,79,94
2437,4,0,6,5,613,3.46666666666667,568,45
2438,2,0,12,5,582,3.36666666666667,553,29
2439,0,0,2,10,312,0.633333333333333,104,208
2440,3,0,2,17,494,1.2,197,297
2441,1,0,2,11,462,1.86666666666667,306,156
2442,0,0,9,0,1273,7.76666666666667,1273,0
2443,1,0,6,9,448,2.2,359,89
2444,0,0,15,0,1201,7.33333333333333,1201,0
2445,0,0,9,0,688,4.18333333333333,688,0
2446,0,1,3,4,366,2.15,352,14
2447,7,13,10,12,799,4.4,722,77
2448,4,2,4,11,548,2.35,386,162
2449,0,0,6,0,550,3.35,550,0
2450,0,0,6,0,518,3.15,518,0
2451,0,1,1,7,95,0.433333333333333,71,24
2452,7,0,4,16,1076,5.51666666666667,904,172
2453,0,2,7,2,222,1.33333333333333,219,3
2454,0,1,2,11,427,1,164,263
2455,0,0,1,13,289,0.666666666666667,109,180
2456,2,0,7,9,674,3.63333333333333,597,77
2457,1,0,1,15,442,0.716666666666667,118,324
2459,0,0,6,0,506,3.08333333333333,506,0
2460,0,0,1,9,204,0.45,74,130
2461,0,1,1,4,228,0.75,123,105
2462,0,0,3,13,344,1.28333333333333,210,134
2463,0,3,4,4,334,1.98333333333333,325,9
2464,0,5,15,0,1419,8.65,1419,0
2465,0,0,4,0,369,2.25,369,0
2466,5,0,13,4,696,3.81666666666667,627,69
2467,2,12,7,2,896,5.43333333333333,891,5
2468,1,14,19,3,2016,12.2,2000,16
2469,0,0,2,3,109,0.6,98,11
2471,0,2,4,3,422,2.41666666666667,396,26
2472,3,1,3,19,611,2.26666666666667,372,239
2473,4,1,6,6,692,3.9,641,51
2475,0,3,6,3,659,3.96666666666667,652,7
2476,1,1,5,8,573,3.33333333333333,547,26
2477,0,2,5,3,498,2.91666666666667,478,20
2478,0,0,7,5,665,3.91666666666667,643,22
2479,0,0,2,10,286,0.516666666666667,85,201
2480,0,2,1,4,136,0.4,66,70
2481,0,0,6,0,702,4.28333333333333,702,0
2482,0,0,5,11,513,2.46666666666667,404,109
2483,0,5,8,0,661,4.03333333333333,661,0
2484,2,0,11,2,527,3.08333333333333,508,19
2485,2,0,2,14,363,1.21666666666667,200,163
2487,0,1,1,11,270,0.716666666666667,118,152
2489,2,0,8,4,551,2.96666666666667,487,64
2490,0,12,12,4,1392,8.11666666666667,1331,61
2491,0,1,12,0,979,5.98333333333333,979,0
2492,4,15,11,6,1316,7.31666666666667,1200,116
2493,0,0,1,10,312,0.55,90,222
2494,0,1,14,1,1203,7.23333333333333,1185,18
2495,4,1,1,13,305,0.85,139,166
2496,0,0,9,0,207,1.26666666666667,207,0
2497,0,1,4,3,307,1.66666666666667,273,34
2498,0,6,11,1,1494,8.88333333333333,1458,36
2499,0,0,10,0,980,5.98333333333333,980,0
2501,0,0,8,0,317,1.93333333333333,317,0
2502,0,0,5,0,497,3.03333333333333,497,0
2503,2,0,9,3,429,2.31666666666667,381,48
2504,0,0,5,0,517,3.15,517,0
2507,0,0,10,0,1088,6.63333333333333,1088,0
2508,5,21,18,10,1692,9.76666666666667,1601,91
2509,1,2,1,5,126,0.483333333333333,79,47
2510,1,0,2,11,250,0.833333333333333,137,113
2511,0,0,5,0,517,3.15,517,0
2512,1,3,14,1,1634,9.75,1598,36
2513,0,0,2,11,335,1.48333333333333,243,92
2514,0,3,5,2,529,3.06666666666667,504,25
2515,1,5,13,1,1289,7.63333333333333,1253,36
2516,0,0,3,0,158,0.966666666666667,158,0
2517,0,0,4,0,399,2.43333333333333,399,0
2518,0,0,5,5,231,1.2,196,35
2519,0,0,6,0,477,2.9,477,0
2521,5,11,13,8,956,5.28333333333333,867,89
2522,1,0,8,1,799,4.86666666666667,798,1
2523,4,11,11,8,868,4.45,729,139
2524,0,0,6,0,472,2.88333333333333,472,0
2525,0,0,1,12,404,1.06666666666667,175,229
2526,0,0,4,8,247,0.966666666666667,158,89
2527,1,1,2,15,464,1.86666666666667,307,157
2528,0,0,2,2,302,1.81666666666667,298,4
2530,0,0,3,10,173,0.616666666666667,101,72
2531,1,5,1,10,264,0.666666666666667,109,155
2532,6,0,1,17,383,0.716666666666667,118,265
2533,0,0,6,8,900,5.33333333333333,874,26
2535,0,0,3,10,433,2.45,402,31
2536,5,1,1,20,447,0.833333333333333,137,310
2538,0,0,2,11,477,2.58333333333333,423,54
2539,6,19,9,7,1273,7.4,1215,58
2541,0,1,2,5,190,1.06666666666667,175,15
2542,0,0,10,6,944,5.7,934,10
2543,0,0,6,0,624,3.8,624,0
2544,6,1,3,15,781,3.35,549,232
2545,0,5,5,6,546,3.16666666666667,519,27
2546,0,4,12,4,1186,6.55,1076,110
2547,0,0,8,0,672,4.1,672,0
2548,0,1,11,1,482,2.81666666666667,461,21
2550,3,0,1,12,366,0.85,139,227
2551,0,2,8,2,633,3.85,631,2
2552,2,10,11,6,543,2.86666666666667,472,71
2553,2,0,7,5,1049,6.2,1016,33
2554,0,0,7,0,691,4.21666666666667,691,0
2555,0,0,11,0,475,2.9,475,0
2556,0,3,6,2,446,2.7,444,2
2557,0,1,7,1,485,2.93333333333333,480,5
2558,7,18,12,10,1583,9.51666666666667,1560,23
2559,4,2,2,14,356,1.58333333333333,260,96
2560,2,2,4,14,673,2.45,402,271
2561,4,3,6,10,554,2.88333333333333,472,82
2562,0,1,6,1,343,2.08333333333333,342,1
2563,0,0,11,0,583,3.56666666666667,583,0
2565,0,0,6,0,420,2.56666666666667,420,0
2567,0,1,13,1,833,4.96666666666667,815,18
2568,0,0,8,0,992,6.05,992,0
2569,0,0,8,0,610,3.71666666666667,610,0
2570,0,0,9,1,518,2.88333333333333,472,46
2571,0,0,5,0,666,4.06666666666667,666,0
2572,0,0,11,0,923,5.61666666666667,923,0
2573,1,0,3,9,727,3.93333333333333,645,82
2574,0,0,8,0,757,4.61666666666667,757,0
2576,1,0,3,5,117,0.65,106,11
2577,0,0,5,11,578,3.03333333333333,497,81
2578,5,2,2,17,473,1.53333333333333,252,221
2579,0,1,3,11,325,1.78333333333333,293,32
2580,0,0,6,0,467,2.85,467,0
2581,0,0,7,0,438,2.66666666666667,438,0
2582,1,0,4,9,455,2.35,386,69
2583,0,0,10,4,804,4.81666666666667,789,15
2584,0,0,10,0,598,3.65,598,0
2585,0,0,13,0,462,2.81666666666667,462,0
2587,0,2,8,0,281,1.71666666666667,281,0
2589,0,0,11,0,667,4.06666666666667,667,0
2591,0,0,8,0,468,2.85,468,0
2592,8,0,5,6,432,2.25,369,63
2593,0,0,11,0,1159,7.06666666666667,1159,0
2594,4,11,11,8,880,4.81666666666667,789,91
2595,0,0,10,0,1115,6.8,1115,0
2597,0,2,12,3,1299,7.65,1252,47
2599,0,0,11,1,1069,6.45,1059,10
2600,1,0,6,6,348,1.85,303,45
2601,3,13,16,2,1525,9.25,1517,8
2602,0,0,2,11,320,1.63333333333333,268,52
2603,0,0,3,0,137,0.833333333333333,137,0
2604,1,0,5,8,486,2.63333333333333,432,54
2605,0,0,5,0,287,1.75,287,0
2606,0,6,6,6,462,2.41666666666667,397,65
2607,2,0,9,2,546,3.28333333333333,539,7
2608,6,1,7,3,534,3.18333333333333,522,12
2609,0,0,11,1,976,5.66666666666667,930,46
2610,0,0,4,0,125,0.766666666666667,125,0
2611,2,1,1,18,438,0.716666666666667,118,320
2612,0,0,6,0,420,2.56666666666667,420,0
2613,0,2,5,0,432,2.63333333333333,432,0
2614,0,0,7,0,590,3.6,590,0
2615,8,0,9,8,832,4.66666666666667,766,66
2616,1,4,12,1,1165,6.8,1115,50
2617,0,0,4,0,260,1.58333333333333,260,0
2618,2,0,13,3,782,4.53333333333333,743,39
2619,0,0,10,0,1215,7.41666666666667,1215,0
2621,0,0,2,12,350,1.13333333333333,186,164
2622,0,0,10,0,355,2.16666666666667,355,0
2623,1,4,7,6,315,1.66666666666667,273,42
2624,0,0,4,2,475,2.78333333333333,457,18
2625,0,0,11,1,863,5.25,862,1
2626,2,12,9,8,607,3.2,526,81
2627,0,0,4,11,527,2.66666666666667,437,90
2629,1,0,4,10,225,0.983333333333333,161,64
2630,0,4,7,1,225,1.36666666666667,224,1
2631,0,0,4,2,373,2.18333333333333,358,15
2632,0,0,9,0,661,4.03333333333333,661,0
2633,2,10,15,1,1100,6.48333333333333,1064,36
2635,0,0,15,0,1489,9.08333333333333,1489,0
2636,0,0,6,2,506,2.96666666666667,486,20
2638,0,0,12,0,390,2.38333333333333,390,0
2639,1,0,4,14,548,2.83333333333333,465,83
2640,4,1,2,16,497,1.58333333333333,260,237
2642,0,0,11,0,504,3.06666666666667,504,0
2643,3,0,2,11,229,0.95,155,74
2644,0,0,7,0,234,1.43333333333333,234,0
2645,10,1,2,18,451,1.66666666666667,274,177
2646,0,0,0,10,56,0,0,56
2647,0,1,5,3,656,3.8,623,33
2648,0,0,4,7,282,1.68333333333333,275,7
2652,0,0,13,0,1110,6.76666666666667,1110,0
2653,0,0,5,0,741,4.51666666666667,741,0
2654,2,0,12,2,569,3.33333333333333,548,21
2655,3,0,12,2,465,2.76666666666667,454,11
2656,0,0,7,0,578,3.51666666666667,578,0
2657,0,0,11,0,1143,6.96666666666667,1143,0
2664,1,1,4,16,413,1.16666666666667,190,223
2665,0,0,6,5,409,2.28333333333333,373,36
2666,0,0,3,15,703,2.08333333333333,341,362
2667,0,0,8,1,665,4.01666666666667,658,7
2668,0,0,6,0,762,4.65,762,0
2683,0,0,6,0,615,3.75,615,0
2686,0,0,6,5,262,1.46666666666667,242,20
2687,0,0,5,0,492,3,492,0
2688,0,0,3,0,82,0.5,82,0
2689,0,0,9,0,651,3.98333333333333,651,0
2690,1,0,2,14,547,2.71666666666667,446,101
2691,12,1,7,0,370,2.25,370,0
2692,0,0,8,0,475,2.9,475,0
2693,0,0,8,7,666,3.56666666666667,583,83
2695,0,4,13,4,1870,11.3,1854,16
2696,2,7,10,4,839,4.83333333333333,793,46
2697,4,2,8,3,577,3.13333333333333,512,65
2698,0,0,3,12,438,0.633333333333333,105,333
2700,2,0,9,4,933,5.58333333333333,916,17
2702,0,0,8,4,846,5.08333333333333,834,12
2703,3,2,2,15,302,0.8,131,171
2704,0,0,9,0,930,5.66666666666667,930,0
2706,0,0,10,2,659,3.78333333333333,619,40
2707,6,0,12,5,817,4.58333333333333,750,67
2708,3,3,11,0,1386,8.45,1386,0
2709,0,0,3,10,423,0.75,123,300
2710,0,0,7,9,554,2.8,457,97
2712,3,0,1,13,303,0.666666666666667,109,194
2713,0,0,3,8,139,0.566666666666667,93,46
2724,0,0,9,8,555,3.16666666666667,520,35
2725,0,0,5,0,527,3.21666666666667,527,0
2726,0,0,10,0,633,3.85,633,0
2727,0,0,7,6,377,1.75,286,91
2728,2,0,5,13,540,2.68333333333333,440,100
2730,0,0,10,0,815,4.96666666666667,815,0
2731,0,0,1,7,115,0.1,16,99
2732,7,2,3,17,629,2.41666666666667,397,232
2733,0,0,6,0,729,4.45,729,0
2734,0,0,5,0,331,2.01666666666667,331,0
2735,6,3,2,21,606,1.78333333333333,293,313
2736,0,0,1,13,218,0.1,16,202
2737,2,1,2,16,535,1.76666666666667,289,246
2738,0,0,6,7,547,3.25,533,14
2739,0,0,10,0,868,5.3,868,0
2740,3,0,3,13,578,2.4,393,185
2741,0,0,7,6,535,2.88333333333333,471,64
2742,0,0,1,8,131,0.1,16,115
2743,0,0,9,0,770,4.7,770,0
2744,0,0,1,10,176,0.1,16,160
2745,4,0,1,16,359,1.16666666666667,191,168
2746,0,0,1,8,109,0.1,16,93
2749,2,1,11,3,881,5,819,62
2750,0,0,10,0,533,3.25,533,0
2752,0,0,11,3,764,4.6,755,9
2754,0,0,7,8,616,3.03333333333333,496,120
2755,0,0,8,1,754,4.31666666666667,708,46
2756,8,0,4,14,593,2.56666666666667,421,172
2757,0,0,7,1,643,3.78333333333333,620,23
2758,3,1,10,7,734,3.91666666666667,642,92
2759,0,0,1,9,148,0.1,16,132
2760,4,0,4,17,752,3.01666666666667,494,258
2761,2,0,1,11,284,0.85,139,145
2762,0,0,9,5,384,2.03333333333333,333,51
2763,0,0,8,0,545,3.31666666666667,545,0
2764,0,0,11,0,636,3.88333333333333,636,0
2765,0,0,6,0,525,3.2,525,0
2766,0,0,6,0,552,3.36666666666667,552,0
2767,0,0,1,10,135,0.1,16,119
2769,0,0,1,7,102,0.1,16,86
2770,0,0,8,0,892,5.43333333333333,892,0
2772,0,0,5,8,473,2.76666666666667,454,19
2773,0,0,10,5,845,4.56666666666667,748,97
2774,0,0,1,8,99,0.1,16,83
2775,2,0,6,8,571,2.83333333333333,464,107
2776,0,1,9,5,433,2.33333333333333,382,51
2778,4,2,1,17,380,0.75,123,257
2779,0,0,1,12,138,0.1,16,122
2780,0,0,4,5,224,1.21666666666667,200,24
2781,0,0,7,6,591,3.5,574,17
2782,2,0,9,3,798,4.65,763,35
2783,0,0,1,9,114,0.1,16,98
2784,0,0,6,2,445,2.53333333333333,415,30
2785,0,1,9,1,1019,5.93333333333333,973,46
2786,1,0,6,4,287,1.48333333333333,243,44
2787,0,0,1,10,146,0.1,16,130
2788,0,0,8,4,628,3.51666666666667,575,53
2789,2,0,5,5,445,2.4,393,52
2790,0,0,7,5,544,3.23333333333333,529,15
2791,1,5,10,0,954,5.81666666666667,954,0
2793,2,4,10,7,793,4.45,730,63
2794,15,0,1,23,388,0.716666666666667,118,270
2795,2,1,5,11,665,2.58333333333333,425,240
2797,5,18,5,17,390,1.51666666666667,249,141
2800,0,2,2,9,219,0.483333333333333,80,139
2801,8,24,8,16,635,2.88333333333333,473,162
2802,4,2,1,17,296,0.483333333333333,79,217
2803,5,2,9,6,778,4.33333333333333,710,68
2806,0,0,10,0,837,5.1,837,0
2810,2,17,11,4,610,3.6,590,20
2813,0,0,2,12,417,1.9,312,105
2814,6,12,5,9,248,1.16666666666667,191,57
2833,3,0,1,13,438,1.51666666666667,249,189
2834,0,0,8,0,373,2.28333333333333,373,0
2835,0,0,5,7,311,1.7,279,32
2836,3,0,4,11,891,4.43333333333333,727,164
2837,2,0,5,7,827,5,820,7
2838,0,0,8,0,391,2.38333333333333,391,0
2839,0,0,9,0,344,2.1,344,0
2840,10,0,7,3,424,2.21666666666667,363,61
2843,8,1,9,1,648,3.93333333333333,646,2
2844,0,3,9,1,824,5,819,5
2845,2,0,11,3,1104,6.7,1098,6
2846,0,0,8,0,378,2.3,378,0
2848,0,0,7,3,629,3.48333333333333,570,59
2849,0,0,9,0,715,4.36666666666667,715,0
2851,1,0,13,3,847,4.76666666666667,782,65
2852,0,0,1,10,229,0.516666666666667,85,144
2853,0,1,10,1,1141,6.91666666666667,1134,7
2854,0,12,12,2,1088,6.35,1042,46
2856,0,1,2,13,383,0.65,107,276
2857,0,0,9,3,718,4.06666666666667,667,51
2858,2,0,4,12,864,4.33333333333333,710,154
2859,0,4,12,1,798,4.83333333333333,793,5
2861,0,0,10,3,802,4.86666666666667,799,3
2862,0,2,15,2,1524,9.03333333333333,1482,42
2863,0,0,5,10,450,2.13333333333333,349,101
2864,1,0,10,2,1335,8.11666666666667,1332,3
2865,0,0,9,1,487,2.95,483,4
2866,2,5,9,2,1419,8.63333333333333,1417,2
2867,2,4,9,4,1457,8.78333333333333,1441,16
2868,0,0,3,12,416,1.03333333333333,169,247
2869,0,0,8,9,574,2.7,442,132
2870,0,0,0,10,101,0,0,101
2872,0,0,7,0,273,1.66666666666667,273,0
2873,4,0,10,6,645,3.5,574,71
2874,0,0,7,0,265,1.61666666666667,265,0
2875,2,0,9,5,848,5.13333333333333,842,6
2876,0,0,5,0,543,3.31666666666667,543,0
2877,0,0,10,0,446,2.71666666666667,446,0
2878,0,2,10,3,2400,14.5666666666667,2389,11
2879,0,0,9,8,673,3.53333333333333,578,95
2880,5,3,9,6,1364,8.18333333333333,1342,22
2881,0,0,1,9,193,0.716666666666667,118,75
2882,0,0,8,0,525,3.2,525,0
2883,1,0,3,8,296,1.5,246,50
2884,0,0,9,0,475,2.9,475,0
2885,3,10,9,3,764,4.23333333333333,694,70
2887,0,2,13,1,808,4.85,796,12
2888,0,0,9,3,915,5.56666666666667,912,3
2889,0,0,7,4,467,2.73333333333333,448,19
2890,0,0,9,0,733,4.46666666666667,733,0
2891,2,5,10,2,948,5.58333333333333,917,31
2892,0,0,1,5,165,0.666666666666667,109,56
2893,3,8,10,2,1097,6.63333333333333,1088,9
2894,0,0,4,13,389,1.06666666666667,175,214
2895,2,0,8,8,629,3.71666666666667,610,19
2896,1,3,14,4,1001,5.55,909,92
2897,0,0,6,7,399,1.88333333333333,308,91
2898,0,1,2,15,338,0.6,99,239
2899,4,0,9,3,692,3.83333333333333,628,64
2900,0,0,4,7,360,1.86666666666667,305,55
2901,0,1,2,10,348,0.65,107,241
2902,0,0,7,4,300,1.73333333333333,285,15
2903,2,1,9,3,694,3.83333333333333,629,65
2904,0,0,6,2,520,2.93333333333333,480,40
2905,0,0,5,10,471,2.8,459,12
2906,5,11,8,4,815,4.83333333333333,793,22
2907,1,7,13,2,1353,7.98333333333333,1309,44
2908,1,0,7,7,600,3.61666666666667,593,7
2909,0,1,11,0,1296,7.9,1296,0
2910,0,0,4,14,374,1.15,189,185
2913,4,9,12,3,1179,7.13333333333333,1169,10
2914,7,1,5,3,319,1.71666666666667,282,37
2915,0,0,10,9,711,3.75,614,97
2916,1,7,4,8,285,1.31666666666667,216,69
2918,1,5,6,2,847,5.03333333333333,826,21
2919,1,0,3,9,474,2.11666666666667,347,127
2920,0,1,10,2,628,3.55,581,47
2921,0,1,6,3,442,2.55,419,23
2922,0,0,9,0,634,3.86666666666667,634,0
2923,0,1,7,2,805,4.83333333333333,794,11
2924,0,0,10,0,513,3.13333333333333,513,0
2925,0,0,1,4,153,0.666666666666667,109,44
2926,2,0,2,12,483,1.6,263,220
2927,0,0,12,0,1079,6.58333333333333,1079,0
2928,0,1,8,2,789,4.75,780,9
2929,0,0,10,0,763,4.65,763,0
2930,0,0,11,0,642,3.91666666666667,642,0
2931,0,0,12,0,745,4.53333333333333,745,0
2932,0,0,0,14,153,0,0,153
2933,0,1,4,5,298,1.61666666666667,266,32
2934,0,1,1,5,190,0.6,98,92
2935,1,9,4,7,315,1.38333333333333,227,88
2936,0,5,4,4,249,1.16666666666667,191,58
2939,0,0,13,0,934,5.7,934,0
2940,0,2,12,1,1219,7.43333333333333,1217,2
2941,0,0,1,8,198,0.483333333333333,79,119
2942,1,7,14,3,1203,6.98333333333333,1147,56
2943,0,0,6,0,499,3.05,499,0
2944,0,0,7,9,720,3.96666666666667,651,69
2946,0,0,7,4,473,2.78333333333333,456,17
2947,0,0,8,1,481,2.9,475,6
2948,5,1,4,14,713,2.98333333333333,488,225
2949,0,0,11,1,1268,7.45,1222,46
2950,1,0,3,10,434,2.21666666666667,364,70
2951,2,0,3,10,460,2.18333333333333,359,101
2952,0,3,1,4,133,0.483333333333333,79,54
2953,0,8,4,3,277,1.38333333333333,227,50
2954,3,20,8,9,424,2.16666666666667,356,68
2955,0,10,8,6,422,2.05,337,85
2956,2,6,7,9,386,1.76666666666667,290,96
2957,2,0,4,9,616,3.03333333333333,498,118
2958,0,2,2,3,101,0.45,73,28
2959,0,0,11,0,608,3.71666666666667,608,0
2960,2,10,7,11,837,4.21666666666667,692,145
2961,0,3,12,0,1071,6.51666666666667,1071,0
2962,2,12,14,2,2126,12.9166666666667,2119,7
2963,1,3,1,5,173,0.7,115,58
2964,0,1,5,3,686,4.06666666666667,668,18
2965,0,0,7,1,369,2.21666666666667,363,6
2966,1,0,3,12,613,2.66666666666667,438,175
2967,1,1,5,4,684,4,657,27
2968,0,6,3,6,194,0.8,131,63
2969,0,1,12,1,992,5.76666666666667,946,46
2970,0,0,12,0,943,5.75,943,0
2972,3,7,6,7,367,1.5,247,120
2973,2,2,1,6,107,0.483333333333333,79,28
2974,0,7,9,6,414,2.11666666666667,347,67
2975,3,1,2,6,178,0.716666666666667,118,60
2976,0,0,8,0,647,3.95,647,0
2977,2,1,2,15,415,1.41666666666667,233,182
2978,1,0,1,5,145,0.45,74,71
2980,0,0,10,0,973,5.93333333333333,973,0
2981,3,14,18,5,1643,9.66666666666667,1584,59
2982,0,0,9,4,646,3.81666666666667,626,20
2983,0,0,9,2,667,3.96666666666667,649,18
2984,2,2,2,5,201,0.616666666666667,101,100
2985,3,11,15,3,2058,12.1833333333333,1997,61
2986,0,3,14,0,1296,7.9,1296,0
2987,0,0,6,0,615,3.75,615,0
2988,0,0,5,0,388,2.36666666666667,388,0
2989,0,0,4,8,424,2.06666666666667,339,85
2990,0,2,2,15,450,1.35,222,228
2991,0,4,13,1,1863,11.15,1827,36
2992,0,2,4,4,513,2.98333333333333,489,24
2993,1,1,3,10,499,2.33333333333333,383,116
2994,0,0,9,0,821,5.01666666666667,821,0
2995,0,0,9,0,783,4.76666666666667,783,0
2996,3,4,5,10,889,4.91666666666667,806,83
2997,0,3,6,3,678,4.06666666666667,667,11
2998,0,0,9,0,689,4.21666666666667,689,0
2999,0,1,9,0,562,3.43333333333333,562,0
3000,0,0,6,0,421,2.56666666666667,421,0
3002,0,0,9,0,620,3.78333333333333,620,0
3003,0,0,10,3,642,3.8,622,20
3004,2,7,2,7,198,0.883333333333333,145,53
3005,0,1,8,1,829,5.03333333333333,826,3
3006,0,0,10,1,561,3.15,515,46
3007,4,14,4,12,317,1.38333333333333,227,90
3009,0,3,2,6,243,1.25,205,38
3010,0,0,10,0,755,4.6,755,0
3012,0,0,11,0,670,4.08333333333333,670,0
3013,2,0,10,4,641,3.43333333333333,565,76
3014,0,0,7,0,774,4.71666666666667,774,0
3015,0,0,8,2,676,3.88333333333333,636,40
3016,0,0,11,0,680,4.15,680,0
3017,0,0,1,8,102,0.1,16,86
3018,0,0,7,1,694,4.2,688,6
3019,0,0,1,9,139,0.1,16,123
3021,0,2,10,2,1037,6,985,52
3022,0,3,5,6,293,1.46666666666667,241,52
3023,2,0,0,8,137,0,0,137
3024,0,0,5,2,484,2.83333333333333,464,20
3025,6,4,0,16,189,0,0,189
3026,1,0,0,6,108,0,0,108
3027,0,1,12,0,1208,7.36666666666667,1208,0
3028,0,0,9,4,640,3.51666666666667,576,64
3030,1,0,2,12,385,1.63333333333333,267,118
3031,9,7,6,14,531,2.33333333333333,383,148
3033,0,0,1,8,94,0.1,16,78
3034,0,0,7,0,432,2.63333333333333,432,0
3035,0,0,1,10,118,0.1,16,102
3036,0,6,8,4,539,3.11666666666667,511,28
3037,0,0,1,13,159,0.1,16,143
3039,0,0,1,12,146,0.1,16,130
3040,0,0,1,8,100,0.1,16,84
3042,2,1,0,10,151,0,0,151
3043,3,5,6,9,523,2.43333333333333,399,124
3045,0,0,1,9,115,0.1,16,99
3046,0,0,8,0,784,4.78333333333333,784,0
3047,0,0,6,0,532,3.25,532,0
3049,0,0,1,15,232,0.1,16,216
3050,0,1,12,0,917,5.58333333333333,917,0
3051,0,0,10,5,782,4.15,680,102
3052,4,5,0,14,164,0,0,164
3053,4,2,4,13,609,2.61666666666667,428,181
3054,0,1,1,1,70,0.416666666666667,68,2
3055,0,1,8,3,488,2.75,450,38
3056,1,0,2,13,493,1.33333333333333,219,274
3057,0,0,9,5,644,3.51666666666667,576,68
3058,1,2,0,13,160,0,0,160
3061,2,5,3,6,266,1.08333333333333,178,88
3062,0,1,9,5,628,3.28333333333333,537,91
3063,0,0,9,0,604,3.68333333333333,604,0
3064,2,1,0,10,253,0,0,253
3065,0,0,9,5,697,3.9,638,59
3066,2,0,7,3,483,2.7,443,40
3067,2,1,2,13,629,2.63333333333333,431,198
3068,1,8,7,5,415,2.15,352,63
3069,0,3,3,5,319,1.73333333333333,284,35
3070,0,0,9,0,898,5.46666666666667,898,0
3071,0,1,0,9,148,0,0,148
3072,0,1,7,1,702,4.23333333333333,696,6
3075,2,0,2,17,512,1.71666666666667,281,231
3076,0,0,12,0,611,3.73333333333333,611,0
3077,0,2,10,1,876,5.06666666666667,830,46
3078,0,1,12,0,1005,6.13333333333333,1005,0
3079,2,1,8,2,435,2.45,402,33
3080,2,1,0,6,107,0,0,107
3081,7,1,2,17,512,1.93333333333333,317,195
3082,0,0,10,0,898,5.48333333333333,898,0
3083,0,2,6,4,610,3.53333333333333,579,31
3084,0,0,1,12,145,0.1,16,129
3085,0,0,7,0,563,3.43333333333333,563,0
3086,4,2,5,11,405,1.6,262,143
3087,0,0,10,1,967,5.61666666666667,921,46
3088,0,0,9,0,781,4.76666666666667,781,0
3089,0,0,9,0,633,3.86666666666667,633,0
3090,4,0,8,5,541,2.85,467,74
3091,4,1,7,4,466,2.6,425,41
3092,0,0,7,2,460,2.7,444,16
3093,3,0,9,4,959,5.45,894,65
3094,0,0,7,3,568,3.08333333333333,505,63
3095,0,0,6,2,716,4.33333333333333,711,5
3096,0,2,4,4,333,1.55,254,79
3097,1,0,2,12,457,1.65,270,187
3098,5,0,5,1,392,2.35,386,6
3099,1,0,2,10,454,2.11666666666667,347,107
3100,1,1,0,9,199,0,0,199
3101,2,2,1,15,379,0.716666666666667,118,261
3102,0,1,9,8,560,2.81666666666667,461,99
3104,3,5,4,8,276,1.35,221,55
3105,1,1,0,8,117,0,0,117
3118,0,0,3,10,430,1.91666666666667,315,115
3119,0,0,5,0,450,2.75,450,0
3120,2,4,6,8,447,2.03333333333333,334,113
3121,0,0,7,8,546,2.96666666666667,486,60
3122,0,2,7,0,724,4.41666666666667,724,0
3123,0,0,6,0,633,3.86666666666667,633,0
3124,2,0,6,4,482,2.53333333333333,415,67
3126,0,2,9,0,904,5.51666666666667,904,0
3127,0,2,9,1,1109,6.75,1108,1
3128,6,2,1,19,312,0.85,139,173
3129,3,0,9,6,604,3.16666666666667,519,85
3130,0,0,9,0,423,2.58333333333333,423,0
3131,6,0,9,4,696,3.98333333333333,654,42
3132,0,0,5,6,522,3.03333333333333,497,25
3133,0,1,6,3,560,3.31666666666667,543,17
3134,2,0,2,14,515,1.73333333333333,284,231
3135,0,2,1,5,94,0.316666666666667,52,42
3136,3,11,10,4,1970,11.8833333333333,1948,22
3137,1,0,14,1,996,5.98333333333333,981,15
3138,0,0,1,10,163,0.1,16,147
3139,0,0,7,7,350,1.65,270,80
3140,0,1,10,1,1221,7.26666666666667,1193,28
3143,0,12,14,2,1163,7.06666666666667,1159,4
3144,14,26,6,45,3136,16.0833333333333,2637,499
3146,0,0,11,0,403,2.45,403,0
3149,0,4,9,4,450,2.71666666666667,446,4
3150,0,10,11,4,851,5.13333333333333,842,9
3152,0,2,9,0,993,6.05,993,0
3153,0,0,57,0,2967,18.0833333333333,2967,0
3154,4,2,20,1,902,5.5,901,1
3156,0,0,71,0,3453,21.05,3453,0
3157,0,0,36,0,2158,13.1666666666667,2158,0
3159,0,13,14,6,922,5.58333333333333,916,6
3162,15,20,6,43,4422,24.5166666666667,4021,401
3164,0,5,12,3,715,4.3,707,8
3165,0,0,84,0,4180,25.4833333333333,4180,0
3166,23,37,8,59,3317,18.3833333333333,3015,302
3167,0,12,13,3,820,4.95,811,9
3168,0,0,42,0,2346,14.3,2346,0
3169,3,0,5,1,429,2.61666666666667,428,1
3170,0,0,75,1,3391,20.65,3390,1
3173,0,8,12,0,1016,6.18333333333333,1016,0
3174,1,14,10,5,796,4.76666666666667,783,13
3175,0,0,57,0,2807,17.1166666666667,2807,0
3176,10,30,6,52,2043,10,1640,403
3177,0,3,10,2,724,4.38333333333333,719,5
3179,0,0,48,2,2740,16.7,2738,2
3180,0,5,9,2,497,3,493,4
3181,0,0,53,0,2805,17.1166666666667,2805,0
3182,0,0,64,0,4107,25.05,4107,0
3183,0,6,13,1,1082,6.6,1081,1
3184,0,10,11,1,1301,7.93333333333333,1300,1
3185,4,0,9,1,922,5.61666666666667,921,1
3186,0,2,11,1,1553,9.45,1549,4
3187,11,40,6,48,3843,20.4666666666667,3357,486
3188,0,11,12,3,824,5,821,3
3192,0,0,79,0,4252,25.9166666666667,4252,0
3193,0,0,10,0,755,4.6,755,0
3194,2,1,12,0,778,4.75,778,0
3195,0,8,15,4,631,3.81666666666667,624,7
3196,6,0,8,3,583,3.53333333333333,580,3
3197,0,0,106,0,4908,29.9333333333333,4908,0
3198,9,16,4,25,1404,7.38333333333333,1211,193
3199,18,40,7,64,3279,17.0333333333333,2794,485
3200,6,11,7,23,3177,17.1833333333333,2817,360
3201,11,0,19,5,2042,12.4166666666667,2037,5
3202,0,0,87,0,3382,20.6333333333333,3382,0
3203,0,4,14,0,793,4.83333333333333,793,0
3204,3,8,14,1,1399,8.51666666666667,1398,1
3205,0,13,14,0,727,4.43333333333333,727,0
3206,0,16,26,0,1263,7.7,1263,0
3207,0,2,12,1,785,4.78333333333333,784,1
3208,0,0,15,0,804,4.9,804,0
3209,0,3,17,0,766,4.66666666666667,766,0
3210,0,1,21,0,946,5.76666666666667,946,0
3212,0,1,14,1,584,3.55,583,1
3214,0,0,12,1,801,4.85,795,6
3216,6,13,13,9,986,5.73333333333333,938,48
3217,1,7,14,0,625,3.81666666666667,625,0
3218,9,10,6,11,1186,6.73333333333333,1104,82
3220,0,2,14,0,818,4.98333333333333,818,0
3221,0,9,22,1,2095,12.7666666666667,2094,1
3223,6,10,13,3,1320,8,1312,8
3224,0,10,20,1,1969,12,1968,1
3225,0,11,25,0,1738,10.5833333333333,1738,0
3228,7,15,7,16,2120,12.6333333333333,2071,49
3229,0,10,19,0,707,4.31666666666667,707,0
3230,1,14,20,1,1342,8.16666666666667,1341,1
3231,4,12,18,3,1767,10.6,1739,28
3232,0,14,24,1,1695,10.3333333333333,1694,1
3233,0,7,17,0,1078,6.56666666666667,1078,0
3234,13,21,5,15,1849,10.7,1754,95
3235,0,0,12,0,551,3.35,551,0
3236,0,24,25,7,2127,12.9333333333333,2120,7
3237,24,24,11,25,2263,13.0333333333333,2137,126
3238,1,17,22,3,1832,11.15,1829,3
3239,6,7,3,11,444,2.51666666666667,413,31
3240,10,7,11,8,727,4.28333333333333,702,25
3241,11,20,6,18,2822,16.75,2747,75
3242,3,28,14,13,2427,14.3833333333333,2358,69
3243,0,7,24,0,962,5.86666666666667,962,0
3244,5,9,6,3,1668,10.15,1664,4
3245,1,1,6,7,368,2.11666666666667,348,20
3246,1,2,11,4,777,4.7,771,6
3247,7,15,14,6,1207,7.21666666666667,1184,23
3248,20,19,7,31,1341,7.38333333333333,1211,130
3249,0,5,15,1,1051,6.4,1050,1
3250,2,15,5,12,1608,9.65,1583,25
3251,0,0,15,0,976,5.95,976,0
3252,0,2,12,0,765,4.66666666666667,765,0
3253,3,9,6,6,533,3.15,517,16
3255,5,16,13,6,544,3.2,523,21
3256,0,1,32,10,3790,23.0166666666667,3771,19
3257,0,14,15,8,1882,11.2666666666667,1847,35
3258,0,11,18,0,558,3.41666666666667,558,0
3259,14,6,5,22,1269,7.4,1214,55
3261,0,11,12,0,990,6.03333333333333,990,0
3264,0,7,20,0,933,5.7,933,0
3265,1,13,22,0,1716,10.4666666666667,1716,0
3266,1,8,16,0,922,5.61666666666667,922,0
3267,11,17,12,10,1506,8.91666666666667,1460,46
3268,1,8,23,0,1101,6.71666666666667,1101,0
3269,0,4,22,12,2190,13.1833333333333,2164,26
3272,0,2,10,0,736,4.48333333333333,736,0
3273,0,4,12,0,640,3.9,640,0
3274,0,2,14,1,1360,8.28333333333333,1359,1
3275,0,1,16,1,955,5.81666666666667,954,1
3276,0,0,12,0,1102,6.71666666666667,1102,0
3277,0,0,11,0,749,4.56666666666667,749,0
3278,0,10,14,6,933,5.65,927,6
3279,1,1,9,0,678,4.13333333333333,678,0
3281,0,1,13,0,708,4.31666666666667,708,0
3282,0,15,16,8,1031,6.21666666666667,1017,14
3283,8,4,4,3,515,3.11666666666667,511,4
3285,6,10,7,13,1669,9.91666666666667,1626,43
3286,0,3,18,0,857,5.21666666666667,857,0
3287,3,2,3,4,523,3.16666666666667,519,4
3288,0,1,8,2,620,3.75,616,4
3289,0,1,11,0,463,2.81666666666667,463,0
3290,0,3,17,0,1699,10.3666666666667,1699,0
3291,4,29,30,13,2416,14.5666666666667,2392,24
3292,3,4,6,6,1245,7.43333333333333,1218,27
3293,2,11,15,4,1215,7.36666666666667,1209,6
3294,0,10,14,3,1385,8.4,1378,7
3297,4,4,6,6,1061,6.36666666666667,1043,18
3298,0,14,4,4,1315,7.91666666666667,1299,16
3299,6,14,7,3,1742,10.5833333333333,1736,6
3300,0,8,11,1,855,5.2,854,1
3301,0,10,11,5,1787,10.8333333333333,1778,9
3302,0,1,10,1,548,3.33333333333333,547,1
3303,0,2,14,1,858,5.21666666666667,856,2
3305,0,4,10,0,819,5,819,0
3307,0,2,5,2,813,4.9,803,10
3309,0,0,11,0,843,5.15,843,0
3310,0,6,8,1,683,4.15,681,2
3311,0,14,14,6,2078,12.6333333333333,2071,7
3312,9,10,2,11,328,1.73333333333333,284,44
3313,0,1,13,0,899,5.48333333333333,899,0
3314,0,1,11,0,774,4.71666666666667,774,0
3315,0,4,13,0,1419,8.65,1419,0
3316,0,10,26,1,2868,17.4833333333333,2867,1
3317,0,6,27,0,3224,19.6666666666667,3224,0
3318,0,22,15,17,1270,7.51666666666667,1232,38
3319,7,11,7,15,1046,6.13333333333333,1006,40
3320,1,12,14,2,1664,10.0833333333333,1655,9
3321,0,5,15,3,1005,6.1,1001,4
3323,0,0,11,0,678,4.13333333333333,678,0
3324,2,5,9,7,1643,9.75,1599,44
3325,5,19,15,19,2080,11.8333333333333,1939,141
3326,5,5,12,9,1512,8.95,1467,45
3328,0,2,15,0,842,5.13333333333333,842,0
3329,0,0,10,0,483,2.95,483,0
3331,0,1,13,0,804,4.9,804,0
3332,2,10,15,10,1602,9.58333333333333,1571,31
3333,3,2,9,3,795,4.81666666666667,790,5
3334,1,16,11,20,1299,7.16666666666667,1175,124
3335,3,12,13,5,1039,6.25,1024,15
3336,5,21,14,17,998,5.26666666666667,864,134
3337,0,2,11,2,823,5,821,2
3339,7,5,18,6,1686,10.1833333333333,1669,17
3340,23,37,7,60,2999,15.05,2469,530
3341,0,0,9,1,668,4.06666666666667,667,1
3343,10,41,5,46,1971,10.1,1657,314
3344,8,56,8,64,3205,15.4166666666667,2529,676
3345,8,9,14,7,1488,8.86666666666667,1455,33
3346,7,19,17,27,1540,8.16666666666667,1340,200
3347,4,1,7,3,548,3.28333333333333,539,9
3348,8,10,14,8,1896,11.3333333333333,1858,38
3350,19,40,10,36,2528,14.1,2311,217
3351,0,0,13,0,750,4.56666666666667,750,0
3352,0,2,17,0,1064,6.48333333333333,1064,0
3353,2,15,18,6,1906,11.45,1879,27
3354,0,3,17,0,957,5.83333333333333,957,0
3355,7,13,5,15,492,2.53333333333333,415,77
3356,2,8,9,9,2367,14.15,2321,46
3357,0,2,10,0,829,5.05,829,0
3358,12,35,14,24,2826,16.6833333333333,2736,90
3359,0,1,11,0,763,4.65,763,0
3360,2,17,13,10,819,4.76666666666667,781,38
3361,0,3,10,4,1306,7.91666666666667,1297,9
3362,1,24,3,13,1091,6.06666666666667,996,95
3363,1,7,11,3,839,5.08333333333333,833,6
3364,10,20,12,25,1475,7.5,1230,245
3366,0,0,11,0,996,6.08333333333333,996,0
3367,0,0,13,0,913,5.56666666666667,913,0
3368,14,21,12,22,2970,17.55,2877,93
3369,0,1,12,0,866,5.28333333333333,866,0
3370,0,3,19,0,1184,7.21666666666667,1184,0
3371,4,16,32,10,4171,25.2833333333333,4148,23
3372,0,11,19,3,2315,14.0833333333333,2311,4
3373,0,2,11,1,733,4.46666666666667,732,1
3374,0,0,11,0,826,5.05,826,0
3375,7,16,8,17,741,3.96666666666667,652,89
3376,9,16,7,21,738,3.81666666666667,626,112
3378,6,10,15,11,1746,10.4333333333333,1711,35
3379,0,0,8,0,413,2.51666666666667,413,0
3380,35,40,5,71,2460,10.75,1764,696
3381,1,0,10,1,528,3.2,525,3
3382,9,8,12,8,1230,7.3,1196,34
3383,0,1,10,0,712,4.33333333333333,712,0
3384,0,7,12,4,770,4.43333333333333,727,43
3385,4,3,8,3,1022,6.13333333333333,1006,16
3386,0,1,14,0,833,5.08333333333333,833,0
3388,0,4,19,0,909,5.53333333333333,909,0
3389,2,9,13,2,1155,7,1147,8
3390,5,20,7,14,1401,8.1,1328,73
3391,3,17,14,14,1861,10.8833333333333,1785,76
3392,2,26,9,20,2342,13.7,2248,94
3393,0,3,11,0,608,3.71666666666667,608,0
3394,0,2,4,3,246,1.21666666666667,199,47
3396,4,3,0,11,171,0,0,171
3401,0,7,13,0,1232,7.51666666666667,1232,0
3403,4,0,7,3,486,2.91666666666667,479,7
3404,1,2,9,6,731,4.36666666666667,716,15
3405,2,1,3,11,480,1.76666666666667,290,190
3406,0,0,4,0,533,3.25,533,0
3435,0,12,13,5,1118,6.78333333333333,1113,5
3436,5,2,4,20,872,3.7,606,266
3623,0,9,12,1,1476,9,1475,1
3624,0,8,11,2,793,4.8,788,5
3654,0,0,11,0,829,5.05,829,0
3655,0,0,4,5,550,2.88333333333333,473,77
3656,2,0,0,17,239,0,0,239
3657,0,0,4,14,288,1.08333333333333,177,111
3658,0,0,6,0,347,2.11666666666667,347,0
3659,3,0,9,1,681,4.08333333333333,670,11
3660,1,0,0,18,286,0,0,286
3661,0,0,5,0,333,2.03333333333333,333,0
3662,0,1,10,2,666,4.05,664,2
3663,0,0,12,0,368,2.23333333333333,368,0
3665,0,1,16,0,911,5.55,911,0
3666,0,0,8,0,276,1.68333333333333,276,0
3667,8,0,9,0,432,2.63333333333333,432,0
3668,0,0,8,2,289,1.7,279,10
3669,0,1,18,0,1032,6.3,1032,0
3670,0,0,9,7,651,3.86666666666667,635,16
3671,7,0,10,0,1138,6.93333333333333,1138,0
3672,2,0,11,1,600,3.65,599,1
3673,0,0,5,0,90,0.55,90,0
3674,3,1,13,1,608,3.7,607,1
3675,1,11,4,3,441,2.65,436,5
3676,2,3,9,9,721,3.93333333333333,645,76
3677,1,6,10,10,783,4.21666666666667,691,92
3678,0,0,6,0,418,2.55,418,0
3679,0,0,6,13,534,2.46666666666667,405,129
3680,5,0,10,0,525,3.2,525,0
3681,3,0,15,0,457,2.78333333333333,457,0
3682,1,0,3,12,343,1.53333333333333,251,92
3683,0,0,8,0,511,3.11666666666667,511,0
3684,0,1,2,2,454,2.45,402,52
3685,1,1,0,14,40,0,0,40
3686,0,0,3,0,71,0.433333333333333,71,0
3687,0,0,4,11,442,2.4,394,48
3688,0,0,4,2,111,0.55,90,21
3689,1,0,7,0,553,3.36666666666667,553,0
3690,5,0,0,17,202,0,0,202
3691,0,1,6,2,513,3.08333333333333,506,7
3692,0,0,3,15,335,1.05,172,163
3693,0,0,6,0,617,3.76666666666667,617,0
3694,0,1,6,2,470,2.81666666666667,463,7
3695,4,4,12,2,1239,7.48333333333333,1229,10
3696,0,0,10,0,670,4.08333333333333,670,0
3697,0,0,7,2,280,1.53333333333333,250,30
3698,0,0,0,6,38,0,0,38
3699,0,1,6,9,646,3.46666666666667,570,76
3700,0,0,3,0,329,2,329,0
3701,0,0,12,0,726,4.43333333333333,726,0
3702,6,12,10,5,1551,9.31666666666667,1529,22
3703,0,0,5,11,454,2.26666666666667,371,83
3704,2,6,1,14,131,0.0833333333333333,14,117
3705,0,0,6,0,273,1.66666666666667,273,0
3706,3,1,0,15,172,0,0,172
3707,0,0,4,0,279,1.7,279,0
3708,2,3,7,5,819,4.58333333333333,752,67
3709,0,0,5,0,331,2.01666666666667,331,0
3710,0,0,4,12,427,2.13333333333333,349,78
3711,0,0,2,0,36,0.216666666666667,36,0
3712,3,0,10,0,471,2.86666666666667,471,0
3713,0,0,2,0,131,0.8,131,0
3714,0,0,3,0,251,1.53333333333333,251,0
3715,5,0,0,20,191,0,0,191
3716,2,4,12,5,1083,6.5,1066,17
3717,0,0,6,0,538,3.28333333333333,538,0
3718,0,0,6,0,304,1.85,304,0
3719,1,0,16,0,496,3.03333333333333,496,0
3720,2,0,0,8,53,0,0,53
3721,0,0,6,3,199,1.1,180,19
3722,0,0,14,0,766,4.66666666666667,766,0
3723,4,0,0,16,203,0,0,203
3724,0,0,3,0,235,1.43333333333333,235,0
3725,0,0,10,3,376,2.23333333333333,366,10
3726,2,0,9,2,415,2.43333333333333,400,15
3727,0,0,10,1,569,3.46666666666667,568,1
3728,5,5,0,15,106,0,0,106
3729,0,0,3,0,188,1.15,188,0
3730,4,0,0,14,132,0,0,132
3731,4,2,0,10,61,0,0,61
3732,0,0,4,0,176,1.06666666666667,176,0
3734,0,0,5,7,446,2.18333333333333,359,87
3735,0,0,13,0,523,3.18333333333333,523,0
3736,0,1,2,0,79,0.483333333333333,79,0
3737,0,0,7,0,400,2.43333333333333,400,0
3738,2,2,0,13,140,0,0,140
3739,0,0,4,8,228,0.966666666666667,158,70
3741,0,0,5,5,338,1.71666666666667,282,56
3742,1,2,15,0,1084,6.61666666666667,1084,0
3743,4,1,0,15,163,0,0,163
3744,0,5,14,0,849,5.18333333333333,849,0
3745,3,8,12,2,750,4.55,746,4
3746,0,0,8,0,514,3.13333333333333,514,0
3747,1,5,4,5,384,1.91666666666667,314,70
3748,0,0,4,3,483,2.81666666666667,463,20
3749,0,0,4,0,405,2.46666666666667,405,0
3750,2,0,0,17,247,0,0,247
3751,3,9,8,8,912,4.91666666666667,806,106
3752,0,0,9,0,681,4.15,681,0
3753,0,0,11,0,1086,6.61666666666667,1086,0
3754,0,1,10,1,682,4.13333333333333,678,4
3755,0,0,8,12,600,2.91666666666667,477,123
3756,4,0,0,20,220,0,0,220
3757,0,0,3,12,457,1.55,254,203
3759,1,0,0,14,219,0,0,219
3760,0,0,7,8,674,3.91666666666667,642,32
3761,4,6,3,10,538,2.95,484,54
3762,0,0,10,0,467,2.85,467,0
3763,0,0,4,3,117,0.533333333333333,87,30
3764,5,0,10,0,687,4.18333333333333,687,0
3765,0,0,6,0,256,1.56666666666667,256,0
3766,0,0,6,7,679,3.78333333333333,620,59
3767,5,5,5,8,732,3.53333333333333,580,152
3768,0,0,10,0,580,3.53333333333333,580,0
3769,1,0,4,12,432,2.4,394,38
3770,0,0,4,0,107,0.65,107,0
3771,0,0,8,0,537,3.26666666666667,537,0
3772,0,0,6,0,366,2.23333333333333,366,0
3773,0,0,8,0,525,3.2,525,0
3774,0,0,4,0,320,1.95,320,0
3775,0,0,5,6,404,2.18333333333333,358,46
3776,0,0,3,0,140,0.85,140,0
3777,0,0,10,0,932,5.68333333333333,932,0
3778,0,0,6,0,398,2.43333333333333,398,0
3779,2,5,10,2,887,5.35,876,11
3780,0,0,8,0,339,2.06666666666667,339,0
3781,4,0,0,19,258,0,0,258
3782,9,7,2,10,615,3.21666666666667,527,88
3783,0,0,3,4,318,1.83333333333333,300,18
3784,4,7,9,14,1079,5.73333333333333,940,139
3785,0,0,4,0,273,1.66666666666667,273,0
3786,0,0,5,0,594,3.61666666666667,594,0
3787,13,0,5,3,367,2.21666666666667,364,3
3788,0,0,15,0,938,5.71666666666667,938,0
3789,0,0,5,10,589,3.28333333333333,539,50
3790,0,0,3,0,159,0.966666666666667,159,0
3791,0,0,4,0,276,1.68333333333333,276,0
3792,0,8,8,5,417,2.45,402,15
3793,10,0,13,1,441,2.68333333333333,440,1
3794,0,0,6,1,171,1.01666666666667,166,5
3795,0,0,5,1,202,1.2,197,5
3796,0,0,10,0,291,1.76666666666667,291,0
3797,6,0,10,2,806,4.9,804,2
3798,0,0,5,3,220,1.21666666666667,199,21
3799,0,0,4,0,378,2.3,378,0
3801,0,0,2,4,233,1.23333333333333,203,30
3802,1,0,8,8,516,2.76666666666667,455,61
3803,0,1,7,2,330,1.9,311,19
3805,3,0,11,0,466,2.83333333333333,466,0
3806,1,0,0,14,282,0,0,282
3807,0,0,5,8,488,2.21666666666667,364,124
3808,0,0,5,2,384,2.21666666666667,364,20
3809,0,1,7,0,393,2.4,393,0
3810,0,0,4,0,191,1.16666666666667,191,0
3811,0,0,3,0,208,1.26666666666667,208,0
3812,0,1,15,1,1312,7.5,1230,82
3813,0,1,3,8,292,1.65,270,22
3815,0,0,0,8,73,0,0,73
3816,7,0,0,15,193,0,0,193
3817,7,1,0,13,108,0,0,108
3818,2,0,3,10,470,2.58333333333333,423,47
3819,1,5,8,7,1153,6.35,1039,114
3820,0,0,6,13,786,4.43333333333333,728,58
3821,3,0,0,14,148,0,0,148
3822,3,4,3,7,354,1.9,312,42
3823,0,1,12,1,708,4.03333333333333,662,46
3824,1,1,0,15,134,0,0,134
3825,0,0,10,0,1018,6.2,1018,0
3826,0,0,3,0,246,1.5,246,0
3827,0,0,4,5,352,2.01666666666667,330,22
3828,0,0,12,0,775,4.73333333333333,775,0
3829,0,2,12,1,631,3.83333333333333,629,2
3830,0,0,7,7,656,3.08333333333333,506,150
3831,0,7,9,6,1224,7.03333333333333,1153,71
3832,4,0,13,0,724,4.41666666666667,724,0
3833,0,0,7,8,541,3.15,518,23
3834,0,0,6,0,435,2.65,435,0
3835,0,1,3,1,270,1.5,246,24
3836,0,0,6,0,378,2.3,378,0
3837,5,0,13,1,527,3.2,526,1
3838,0,0,7,0,531,3.23333333333333,531,0
3839,2,0,13,1,593,3.6,592,1
3840,0,0,2,0,69,0.416666666666667,69,0
3841,3,0,0,21,282,0,0,282
3842,0,0,8,0,439,2.68333333333333,439,0
3843,0,0,3,0,114,0.7,114,0
3844,0,0,6,0,462,2.81666666666667,462,0
3845,0,1,8,1,175,1.05,173,2
3846,0,0,7,0,593,3.61666666666667,593,0
3847,0,0,6,2,582,3.36666666666667,553,29
3848,1,0,9,0,416,2.53333333333333,416,0
3849,0,0,7,1,206,1.21666666666667,198,8
3850,0,1,12,0,818,5,818,0
3851,0,0,7,0,546,3.33333333333333,546,0
3852,0,0,5,0,283,1.71666666666667,283,0
3853,0,0,6,0,257,1.56666666666667,257,0
3854,1,1,0,17,238,0,0,238
3855,7,17,8,10,1691,10.0333333333333,1645,46
3875,0,14,14,4,1215,7.36666666666667,1208,7
3876,0,2,10,0,506,3.08333333333333,506,0
3877,0,17,20,2,2216,13.5,2214,2
3878,0,4,12,2,1777,10.8,1772,5
3879,0,0,10,0,1022,6.23333333333333,1022,0
3880,0,0,3,0,746,4.55,746,0
3881,0,0,8,0,888,5.41666666666667,888,0
3896,4,0,5,13,881,3.88333333333333,636,245
3897,3,0,2,12,515,2.2,361,154
3898,0,0,9,2,973,5.91666666666667,971,2
3899,1,0,5,12,249,1.43333333333333,235,14
3900,0,0,2,0,334,2.03333333333333,334,0
3901,0,0,1,9,108,0.166666666666667,27,81
3902,0,7,14,0,914,5.56666666666667,914,0
3903,2,2,1,10,276,0.516666666666667,85,191
3904,0,0,2,13,205,0.35,57,148
3905,0,0,6,4,405,2.28333333333333,375,30
3906,2,0,8,1,603,3.68333333333333,602,1
3907,1,0,0,9,80,0,0,80
3908,0,0,9,6,1124,6.81666666666667,1118,6
3909,0,0,1,12,207,0.183333333333333,30,177
3910,6,14,6,2,360,2.16666666666667,356,4
3911,0,1,11,0,407,2.48333333333333,407,0
3912,0,0,1,11,112,0.183333333333333,30,82
3913,1,0,6,2,213,1.25,206,7
3914,0,0,2,0,391,2.38333333333333,391,0
3915,0,0,9,1,381,2.3,376,5
3917,0,0,5,0,254,1.55,254,0
3918,0,1,6,2,180,1.08333333333333,178,2
3919,0,2,7,3,324,1.9,310,14
3920,0,0,2,0,268,1.63333333333333,268,0
3921,8,14,4,10,265,1.43333333333333,235,30
3922,0,0,1,12,164,0.183333333333333,30,134
3924,0,0,7,0,477,2.9,477,0
3925,4,0,0,16,177,0,0,177
3926,0,1,4,1,242,1.45,238,4
3927,0,1,6,6,434,2.48333333333333,408,26
3928,0,0,9,7,704,3.81666666666667,627,77
3929,0,0,6,0,288,1.75,288,0
3930,0,0,1,14,191,0.183333333333333,30,161
3931,2,0,0,11,125,0,0,125
3932,3,0,0,13,126,0,0,126
3933,1,12,8,3,800,4.8,787,13
3934,0,0,3,0,155,0.95,155,0
3935,0,0,4,6,285,1.45,239,46
3936,0,2,4,0,142,0.866666666666667,142,0
3937,0,4,8,3,312,1.75,287,25
3938,0,1,6,0,244,1.48333333333333,244,0
3939,3,5,0,15,145,0,0,145
3940,3,0,13,0,668,4.08333333333333,668,0
3941,0,0,15,0,790,4.81666666666667,790,0
3943,0,0,10,0,421,2.56666666666667,421,0
3944,4,1,0,20,304,0,0,304
3945,0,0,7,7,687,3.86666666666667,634,53
3946,0,1,13,0,561,3.43333333333333,561,0
3947,3,0,0,18,251,0,0,251
3948,0,0,2,0,137,0.833333333333333,137,0
3949,0,0,14,1,738,4.23333333333333,692,46
3950,0,0,10,5,541,2.86666666666667,469,72
3951,0,0,0,14,175,0,0,175
3952,2,1,4,7,873,4.46666666666667,733,140
3953,0,0,7,0,755,4.6,755,0
3955,0,0,2,0,339,2.06666666666667,339,0
3957,0,0,12,1,718,4.38333333333333,717,1
3958,2,10,6,4,269,1.56666666666667,257,12
3959,0,0,7,6,405,2.26666666666667,371,34
3960,0,0,4,5,254,1.3,213,41
3961,0,0,9,0,359,2.18333333333333,359,0
3962,0,0,3,12,209,1.13333333333333,187,22
3963,0,8,4,3,456,2.75,451,5
3964,0,0,3,0,429,2.61666666666667,429,0
3965,0,0,3,0,334,2.03333333333333,334,0
3966,3,10,3,7,250,1.1,181,69
3967,0,1,5,2,185,1,164,21
3968,4,5,8,12,1686,9.61666666666667,1577,109
3969,0,1,11,0,309,1.88333333333333,309,0
3970,0,1,6,3,240,1.41666666666667,232,8
3971,0,0,5,12,511,2.98333333333333,490,21
3972,0,0,14,0,848,5.16666666666667,848,0
3973,3,4,10,8,1249,6.65,1090,159
3974,0,1,16,1,1017,5.95,973,44
3975,0,0,6,2,136,0.816666666666667,134,2
3976,7,8,1,16,595,2.36666666666667,388,207
3977,1,8,5,4,391,2.28333333333333,374,17
3978,1,0,5,9,340,2.01666666666667,331,9
3980,0,0,7,3,348,2.06666666666667,338,10
3981,0,0,5,3,531,3.05,500,31
3982,0,0,10,0,1222,7.45,1222,0
3984,0,0,7,0,564,3.43333333333333,564,0
3985,0,0,5,0,424,2.58333333333333,424,0
3986,0,0,13,0,587,3.58333333333333,587,0
3987,0,2,15,0,648,3.95,648,0
3988,1,1,1,9,103,0.183333333333333,30,73
3989,7,2,0,25,361,0,0,361
3990,0,0,6,0,392,2.38333333333333,392,0
3991,8,1,0,16,191,0,0,191
3992,0,1,6,0,208,1.26666666666667,208,0
3993,0,0,4,2,101,0.6,99,2
3994,0,0,15,0,733,4.46666666666667,733,0
3995,2,7,9,5,1353,8.06666666666667,1323,30
3996,4,3,0,15,247,0,0,247
3997,3,1,7,7,522,3.03333333333333,497,25
3998,0,0,8,0,241,1.46666666666667,241,0
3999,3,0,0,14,132,0,0,132
4000,0,0,7,4,486,2.78333333333333,456,30
4001,0,0,12,0,987,6.01666666666667,987,0
4002,0,0,2,0,391,2.38333333333333,391,0
4003,0,0,12,0,571,3.48333333333333,571,0
4004,3,3,4,10,647,3.15,517,130
4005,0,0,5,3,310,1.71666666666667,281,29
4006,4,0,0,17,221,0,0,221
4007,1,1,0,15,138,0,0,138
4008,0,0,3,8,246,1.45,238,8
4010,0,0,9,0,423,2.58333333333333,423,0
4011,0,0,10,0,373,2.28333333333333,373,0
4013,0,0,5,5,389,2.08333333333333,341,48
4014,0,1,7,1,258,1.56666666666667,257,1
4015,2,4,6,3,315,1.53333333333333,251,64
4016,0,0,8,2,333,1.96666666666667,323,10
4018,3,0,0,17,201,0,0,201
4020,0,1,11,0,348,2.11666666666667,348,0
4021,0,0,9,0,243,1.48333333333333,243,0
4022,3,0,0,13,201,0,0,201
4023,0,0,9,2,560,3.35,549,11
4024,2,0,10,2,785,4.78333333333333,783,2
4025,2,14,2,8,129,0.683333333333333,112,17
4026,3,0,0,13,134,0,0,134
4027,0,0,2,12,197,0.35,57,140
4028,0,0,0,12,66,0,0,66
4029,8,1,0,19,312,0,0,312
4030,0,0,6,0,255,1.55,255,0
4031,3,0,0,18,221,0,0,221
4032,0,0,1,14,165,0.166666666666667,27,138
4033,3,5,4,6,383,1.9,312,71
4034,0,6,4,10,387,1.81666666666667,298,89
4035,0,0,6,2,464,2.78333333333333,456,8
4036,0,1,5,4,380,2.15,352,28
4037,0,0,1,10,96,0.166666666666667,27,69
4038,0,0,2,0,339,2.06666666666667,339,0
4039,2,0,0,18,261,0,0,261
4040,0,1,5,0,256,1.56666666666667,256,0
4041,0,0,6,7,475,2.33333333333333,383,92
4042,0,0,7,0,396,2.41666666666667,396,0
4043,1,3,3,8,492,1.83333333333333,301,191
4044,2,0,7,12,586,3.5,574,12
4045,2,2,1,8,290,0.9,148,142
4046,0,0,2,0,399,2.43333333333333,399,0
4047,0,0,5,9,384,2.28333333333333,375,9
4048,2,0,0,21,224,0,0,224
4049,0,0,12,0,588,3.58333333333333,588,0
4050,0,0,11,4,493,2.81666666666667,463,30
4051,0,1,12,4,516,2.85,466,50
4052,2,13,5,3,327,1.95,320,7
4053,0,1,5,0,170,1.03333333333333,170,0
4054,0,0,9,0,731,4.45,731,0
4055,0,0,8,0,638,3.9,638,0
4056,0,0,7,0,746,4.55,746,0
4057,0,0,8,0,673,4.1,673,0
4058,0,0,10,0,920,5.61666666666667,920,0
4059,0,0,3,0,362,2.2,362,0
4060,0,0,10,0,814,4.96666666666667,814,0
4062,6,0,14,5,2130,12.95,2125,5
4065,0,2,8,3,376,1.91666666666667,313,63
4066,0,0,8,5,490,2.53333333333333,415,75
4067,4,12,8,6,569,3.03333333333333,498,71
4068,7,5,0,20,284,0,0,284
4069,1,1,7,4,1391,8.3,1362,29
4070,0,0,7,0,595,3.63333333333333,595,0
4071,0,0,3,5,189,0.966666666666667,159,30
4072,7,6,1,13,241,0.7,115,126
4073,0,0,5,2,299,1.58333333333333,258,41
4074,11,0,0,21,226,0,0,226
4075,0,0,3,0,388,2.36666666666667,388,0
4076,1,16,6,4,333,1.93333333333333,317,16
4077,7,7,0,21,316,0,0,316
4078,0,0,3,7,141,0.816666666666667,134,7
4079,0,0,11,1,1108,6.73333333333333,1105,3
4080,2,6,7,10,933,4.8,787,146
4081,0,0,3,6,139,0.666666666666667,109,30
4082,0,2,5,0,132,0.8,132,0
4083,2,7,5,8,455,2.28333333333333,374,81
4084,0,0,4,1,168,1,163,5
4085,0,2,13,0,1827,11.1333333333333,1827,0
4086,1,0,14,0,1896,11.5666666666667,1896,0
4087,0,0,2,0,328,2,328,0
4089,0,0,10,0,972,5.93333333333333,972,0
4091,0,0,3,8,288,1.56666666666667,257,31
4092,1,3,0,13,202,0,0,202
4093,0,0,5,0,240,1.46666666666667,240,0
4094,0,1,2,3,428,2.53333333333333,416,12
4095,1,6,5,2,317,1.86666666666667,305,12
4096,2,5,3,6,216,0.883333333333333,145,71
4097,0,0,5,0,434,2.65,434,0
4098,0,0,6,2,220,1.21666666666667,199,21
4099,4,1,0,15,225,0,0,225
4100,7,0,0,17,151,0,0,151
4102,0,0,11,2,496,2.88333333333333,471,25
4103,1,18,2,1,109,0.583333333333333,96,13
4104,0,1,2,2,410,2.46666666666667,405,5
4105,0,0,2,0,309,1.88333333333333,309,0
4106,1,0,10,4,1200,7.11666666666667,1167,33
4107,2,11,6,4,760,4.25,696,64
4108,3,0,0,15,227,0,0,227
4109,0,0,2,0,317,1.93333333333333,317,0
4110,1,0,9,0,334,2.03333333333333,334,0
4111,0,0,6,3,728,4,656,72
4112,0,0,10,4,476,2.71666666666667,445,31
4113,1,0,7,11,709,3.88333333333333,637,72
4114,0,0,5,1,218,1.23333333333333,202,16
4115,6,8,8,6,663,3.56666666666667,584,79
4116,5,7,0,15,243,0,0,243
4117,0,0,5,6,448,1.61666666666667,266,182
4118,0,1,7,0,910,5.55,910,0
4119,1,0,3,13,369,1.88333333333333,308,61
4120,0,0,10,0,1549,9.45,1549,0
4121,1,0,0,16,160,0,0,160
4122,4,1,3,14,470,2,328,142
4123,0,0,4,0,183,1.11666666666667,183,0
4124,0,0,5,12,704,3.9,639,65
4125,1,0,0,15,77,0,0,77
4126,0,1,14,0,1763,10.75,1763,0
4127,0,0,3,0,585,3.56666666666667,585,0
4128,0,0,7,2,317,1.8,296,21
4129,4,8,0,27,451,0,0,451
4130,0,1,10,0,858,5.23333333333333,858,0
4132,0,0,0,10,99,0,0,99
4133,0,0,7,0,816,4.96666666666667,816,0
4136,5,0,8,1,260,1.58333333333333,259,1
4137,2,1,0,17,245,0,0,245
4138,0,0,2,1,255,1.51666666666667,249,6
4139,0,0,10,1,378,2.21666666666667,361,17
4140,0,1,10,3,1747,10.3666666666667,1699,48
4141,0,0,5,1,180,1.06666666666667,175,5
4142,3,6,0,16,213,0,0,213
4143,0,0,12,0,2032,12.4,2032,0
4144,0,0,5,2,180,1.03333333333333,169,11
4146,0,0,6,0,265,1.61666666666667,265,0
4147,0,0,13,0,1771,10.8,1771,0
4148,0,0,2,1,416,2.51666666666667,413,3
4149,4,0,11,1,653,3.96666666666667,652,1
4150,3,12,5,11,613,3.25,533,80
4151,0,0,10,0,776,4.73333333333333,776,0
4152,1,6,9,11,1907,11.2,1836,71
4153,0,0,4,0,742,4.53333333333333,742,0
4154,2,0,6,9,407,2.3,377,30
4155,0,0,3,2,363,2.16666666666667,355,8
4156,0,0,7,0,411,2.5,411,0
4157,0,10,2,3,116,0.333333333333333,55,61
4158,0,0,5,1,233,1.31666666666667,216,17
4159,0,0,9,0,615,3.75,615,0
4160,1,0,3,9,217,1.03333333333333,170,47
4161,1,0,6,10,443,2.4,393,50
4162,12,7,0,16,158,0,0,158
4163,0,0,2,0,315,1.91666666666667,315,0
4164,0,0,7,4,289,1.63333333333333,267,22
4165,4,1,0,20,230,0,0,230
4166,10,0,8,4,499,3.01666666666667,495,4
4167,0,0,7,0,784,4.78333333333333,784,0
4168,4,5,0,21,336,0,0,336
4169,0,0,8,0,654,3.98333333333333,654,0
4170,0,0,5,0,424,2.58333333333333,424,0
4171,0,0,5,2,459,2.75,451,8
4173,3,0,0,17,252,0,0,252
4176,3,5,0,13,132,0,0,132
4177,0,1,7,0,475,2.9,475,0
4178,1,0,0,20,332,0,0,332
4179,1,0,11,0,749,4.56666666666667,749,0
4180,0,0,7,3,659,3.95,647,12
4181,0,0,6,0,516,3.15,516,0
4182,0,0,8,0,684,4.16666666666667,684,0
4183,0,3,6,0,205,1.25,205,0
4184,7,12,6,8,449,2.51666666666667,413,36
4185,0,0,5,2,232,1.4,230,2
4186,0,2,6,3,535,3.18333333333333,523,12
4187,0,0,5,1,218,1.28333333333333,211,7
4188,0,0,7,3,282,1.56666666666667,258,24
4189,0,0,5,0,297,1.81666666666667,297,0
4190,1,2,0,8,135,0,0,135
4191,7,2,0,19,201,0,0,201
4192,0,0,6,0,418,2.55,418,0
4193,0,0,10,0,694,4.23333333333333,694,0
4195,0,10,5,2,371,2.23333333333333,366,5
4196,0,0,6,0,476,2.9,476,0
4197,1,2,4,2,126,0.666666666666667,110,16
4198,0,0,8,0,479,2.93333333333333,479,0
4199,0,0,8,0,684,4.16666666666667,684,0
4200,0,3,8,0,634,3.86666666666667,634,0
4201,0,0,11,0,629,3.83333333333333,629,0
4202,0,0,10,0,622,3.8,622,0
4203,0,0,5,1,353,2.11666666666667,346,7
4204,4,6,7,9,524,2.68333333333333,439,85
4205,0,0,7,0,386,2.35,386,0
4206,4,3,0,9,242,0,0,242
4207,0,0,4,0,343,2.08333333333333,343,0
4208,0,0,8,1,400,2.33333333333333,383,17
4209,0,0,5,0,369,2.25,369,0
4210,1,3,5,1,180,1.05,173,7
4211,0,1,6,4,351,2.05,336,15
4212,4,0,0,16,128,0,0,128
4213,0,0,9,2,449,2.61666666666667,430,19
4214,1,8,4,7,378,1.86666666666667,306,72
4215,0,2,5,7,486,2.71666666666667,446,40
4216,0,0,7,1,385,2.25,368,17
4217,0,1,10,0,760,4.63333333333333,760,0
4218,0,0,4,1,167,0.983333333333333,161,6
4219,0,0,7,0,609,3.71666666666667,609,0
4220,0,2,6,4,709,4.21666666666667,692,17
4221,1,0,6,0,476,2.9,476,0
4222,2,1,6,1,185,1.08333333333333,178,7
4223,0,0,5,0,152,0.933333333333333,152,0
4224,0,0,8,0,456,2.78333333333333,456,0
4225,2,10,8,4,460,2.68333333333333,440,20
4226,0,0,6,0,330,2.01666666666667,330,0
4227,0,0,5,0,233,1.41666666666667,233,0
4228,0,0,5,0,560,3.41666666666667,560,0
4229,5,5,0,13,177,0,0,177
4230,0,3,6,2,224,1.31666666666667,216,8
4231,0,0,9,4,775,4.63333333333333,760,15
4232,11,18,3,12,210,0.866666666666667,141,69
4233,0,0,5,1,119,0.683333333333333,112,7
4234,0,0,2,17,319,1.1,181,138
4235,8,0,0,19,192,0,0,192
4236,3,15,5,8,472,2.58333333333333,423,49
4237,0,1,4,2,359,2.11666666666667,348,11
4238,0,0,13,0,734,4.46666666666667,734,0
4239,5,8,9,9,748,4.3,704,44
4240,3,0,0,17,208,0,0,208
4241,3,3,0,17,184,0,0,184
4242,0,0,4,0,190,1.16666666666667,190,0
4243,0,1,6,0,464,2.83333333333333,464,0
4244,4,1,0,19,284,0,0,284
4245,3,0,0,16,250,0,0,250
4246,3,8,7,5,617,3.36666666666667,551,66
4247,6,12,5,7,300,1.38333333333333,226,74
4248,4,1,0,19,279,0,0,279
4250,0,0,5,0,257,1.56666666666667,257,0
4251,1,1,8,5,213,1.21666666666667,199,14
4252,2,0,0,14,286,0,0,286
4253,0,0,0,4,31,0,0,31
4254,0,0,6,0,607,3.7,607,0
4256,3,0,0,19,241,0,0,241
4257,5,0,0,19,284,0,0,284
4258,0,3,0,11,127,0,0,127
4259,0,0,6,4,583,3.25,532,51
4260,2,10,7,5,520,2.75,450,70
4262,1,2,0,15,234,0,0,234
4263,0,0,10,0,842,5.13333333333333,842,0
4264,0,0,8,0,672,4.08333333333333,672,0
4265,2,14,5,11,600,2.98333333333333,489,111
4266,0,0,5,0,290,1.76666666666667,290,0
4267,4,1,0,17,250,0,0,250
4268,4,0,0,22,265,0,0,265
4269,0,0,5,0,191,1.16666666666667,191,0
4270,1,1,0,12,162,0,0,162
4271,0,0,3,0,259,1.58333333333333,259,0
4272,2,1,0,10,150,0,0,150
4274,1,13,7,3,581,3.11666666666667,511,70
4275,4,9,4,9,347,1.43333333333333,235,112
4276,4,1,0,22,254,0,0,254
4277,0,0,8,0,398,2.43333333333333,398,0
4278,0,0,1,9,109,0.183333333333333,30,79
4279,7,12,6,11,465,2.05,337,128
4280,2,2,0,14,306,0,0,306
4281,0,0,6,2,490,2.9,475,15
4282,0,2,9,0,563,3.43333333333333,563,0
4283,0,0,2,0,170,1.03333333333333,170,0
4284,0,0,2,10,211,0.35,57,154
4285,5,1,0,17,209,0,0,209
4286,0,11,3,3,182,0.9,148,34
4287,1,2,0,22,237,0,0,237
4288,1,0,0,10,138,0,0,138
4289,0,0,3,0,449,2.73333333333333,449,0
4293,7,7,0,14,203,0,0,203
4295,3,0,0,18,240,0,0,240
4296,2,6,0,10,100,0,0,100
4297,7,0,0,14,134,0,0,134
4298,0,1,0,20,329,0,0,329
4299,0,3,8,0,419,2.55,419,0
4300,0,0,2,14,218,0.35,57,161
4301,0,0,2,13,213,0.35,57,156
4303,2,1,3,2,560,3.38333333333333,555,5
4304,0,0,3,5,271,1.41666666666667,232,39
4305,0,7,6,8,390,1.76666666666667,290,100
4306,5,2,0,13,244,0,0,244
4307,8,0,0,21,227,0,0,227
4308,0,0,7,1,548,3.33333333333333,547,1
4309,0,0,4,0,343,2.1,343,0
4311,0,2,9,0,399,2.43333333333333,399,0
4312,0,0,6,5,453,2.5,411,42
4313,0,1,11,0,893,5.45,893,0
4314,5,0,0,22,246,0,0,246
4315,3,3,0,18,243,0,0,243
4316,0,1,8,0,381,2.31666666666667,381,0
4317,0,0,8,4,459,2.66666666666667,438,21
4318,2,1,0,11,139,0,0,139
4319,0,0,6,5,539,3.18333333333333,522,17
4320,0,0,3,1,106,0.55,90,16
4321,0,0,5,0,415,2.53333333333333,415,0
4322,0,0,3,4,277,1.51666666666667,249,28
4323,0,0,2,13,207,0.35,57,150
4324,2,0,0,15,268,0,0,268
4325,0,0,5,2,495,2.91666666666667,477,18
4326,1,1,6,1,207,1.23333333333333,202,5
4327,0,1,9,4,720,4.26666666666667,699,21
4328,0,0,1,12,171,0.183333333333333,30,141
4329,0,0,2,13,199,0.35,57,142
4330,2,0,0,22,332,0,0,332
4331,0,0,5,0,383,2.33333333333333,383,0
4332,0,0,7,0,521,3.18333333333333,521,0
4333,0,0,4,0,478,2.91666666666667,478,0
4334,0,3,0,14,167,0,0,167
4336,4,0,0,17,229,0,0,229
4337,6,0,0,15,149,0,0,149
4338,0,0,8,0,269,1.65,269,0
4339,0,2,9,1,298,1.81666666666667,297,1
4340,0,1,8,0,555,3.38333333333333,555,0
4341,0,1,4,0,128,0.783333333333333,128,0
4342,0,0,2,12,191,0.35,57,134
4343,4,0,0,21,288,0,0,288
4344,0,0,7,0,356,2.16666666666667,356,0
4345,0,1,6,1,230,1.3,214,16
4346,1,4,0,18,180,0,0,180
4347,0,0,2,13,227,0.35,57,170
4348,0,0,0,16,158,0,0,158
4349,0,0,6,0,471,2.86666666666667,471,0
4350,0,9,5,6,379,1.7,278,101
4351,0,0,5,0,503,3.06666666666667,503,0
4352,0,0,5,0,200,1.21666666666667,200,0
4353,0,0,2,15,286,0.35,57,229
4354,0,1,6,0,237,1.45,237,0
4355,0,1,6,0,197,1.2,197,0
4356,0,1,7,0,322,1.96666666666667,322,0
4357,3,3,0,12,99,0,0,99
4358,0,7,5,4,257,1.36666666666667,224,33
4362,1,10,6,8,551,2.8,459,92
4364,7,0,0,17,257,0,0,257
4365,0,1,6,1,246,1.45,238,8
4366,0,1,11,2,640,3.66666666666667,599,41
4367,0,0,4,0,155,0.95,155,0
4368,5,4,0,18,264,0,0,264
4369,6,0,13,0,861,5.25,861,0
4370,6,2,0,20,558,0,0,558
4371,0,0,11,1,464,2.33333333333333,382,82
4372,5,6,3,10,271,0.933333333333333,153,118
4373,1,3,0,12,201,0,0,201
4374,0,0,10,0,502,3.06666666666667,502,0
4375,0,1,12,0,741,4.51666666666667,741,0
4376,0,0,9,0,282,1.71666666666667,282,0
4377,0,0,9,4,464,2.46666666666667,405,59
4378,0,0,7,3,694,4.15,681,13
4379,0,0,0,15,119,0,0,119
4380,0,0,4,11,969,3.66666666666667,600,369
4381,0,0,7,0,330,2.01666666666667,330,0
4382,0,0,3,0,181,1.1,181,0
4383,2,0,0,18,229,0,0,229
4384,7,3,0,16,133,0,0,133
4385,0,0,5,6,428,2.21666666666667,364,64
4386,0,0,8,0,493,3,493,0
4387,3,0,0,18,298,0,0,298
4388,0,2,0,13,152,0,0,152
4389,0,0,6,0,553,3.36666666666667,553,0
4390,0,0,9,0,493,3,493,0
4391,0,0,5,0,375,2.28333333333333,375,0
4407,0,0,5,0,358,2.18333333333333,358,0
4408,0,0,2,0,227,1.38333333333333,227,0
4409,0,0,8,5,463,2.78333333333333,457,6
4410,0,3,9,3,381,2.21666666666667,362,19
4411,3,5,0,16,190,0,0,190
4412,3,1,0,19,309,0,0,309
4414,0,0,5,4,313,1.88333333333333,309,4
4415,0,0,11,0,645,3.93333333333333,645,0
4416,0,0,7,8,649,3.83333333333333,628,21
4417,0,0,3,0,260,1.58333333333333,260,0
4419,10,16,0,30,477,0,0,477
4420,0,0,5,4,480,2.86666666666667,470,10
4421,0,0,5,0,544,3.31666666666667,544,0
4422,0,0,6,0,410,2.5,410,0
4423,0,0,1,0,260,1.58333333333333,260,0
4424,0,0,2,3,185,0.9,148,37
4425,0,0,7,0,288,1.75,288,0
4426,0,0,5,1,563,3.4,559,4
4427,1,0,2,12,226,1.23333333333333,202,24
4428,0,0,7,0,262,1.6,262,0
4429,1,7,11,2,1004,6.1,1000,4
4430,0,0,9,4,242,1.45,236,6
4431,0,1,5,3,417,2.48333333333333,407,10
4432,0,0,2,1,321,1.95,320,1
4433,0,0,5,0,304,1.85,304,0
4434,6,6,0,6,117,0,0,117
4435,1,0,2,11,197,0.35,57,140
4437,0,0,0,5,44,0,0,44
4438,0,0,5,0,435,2.65,435,0
4439,0,0,6,2,215,1.26666666666667,207,8
4440,0,0,5,0,530,3.23333333333333,530,0
4441,0,0,0,12,53,0,0,53
4442,0,0,5,4,428,2.55,419,9
4443,2,0,0,13,157,0,0,157
4444,3,3,0,5,106,0,0,106
4445,0,0,8,1,584,3.53333333333333,580,4
4446,0,0,4,2,147,0.866666666666667,143,4
4447,0,0,5,2,185,1.1,181,4
4448,2,15,9,2,770,4.66666666666667,765,5
4449,0,0,3,12,296,1.5,246,50
4450,0,0,2,0,129,0.783333333333333,129,0
4451,0,0,10,0,405,2.46666666666667,405,0
4452,1,0,0,10,20,0,0,20
4453,0,1,4,1,382,2.26666666666667,371,11
4454,0,0,6,0,129,0.783333333333333,129,0
4455,3,0,11,0,744,4.53333333333333,744,0
4456,0,0,2,0,311,1.9,311,0
4457,0,2,1,12,178,0.6,98,80
4458,0,10,9,0,645,3.93333333333333,645,0
4459,0,0,2,0,99,0.6,99,0
4460,0,0,4,0,421,2.56666666666667,421,0
4461,0,0,5,0,405,2.46666666666667,405,0
4462,3,1,4,11,231,0.95,156,75
4463,0,0,1,17,188,0.616666666666667,101,87
4464,3,0,0,14,141,0,0,141
4465,6,0,11,0,659,4.01666666666667,659,0
4466,2,4,0,14,143,0,0,143
4467,2,0,1,15,267,0.533333333333333,87,180
4468,1,0,2,13,337,1.68333333333333,276,61
4469,0,0,7,0,313,1.9,313,0
4470,0,0,4,3,127,0.716666666666667,118,9
4471,0,0,0,10,85,0,0,85
4472,0,0,0,4,32,0,0,32
4473,0,0,2,0,320,1.95,320,0
4474,3,10,10,4,686,4.15,680,6
4475,2,0,1,13,185,0.183333333333333,30,155
4476,0,0,0,18,109,0,0,109
4477,0,0,0,10,96,0,0,96
4478,0,0,3,2,54,0.3,50,4
4479,0,1,4,2,147,0.866666666666667,143,4
4480,0,0,10,2,578,3.48333333333333,571,7
4482,2,0,2,18,204,0.8,132,72
4483,0,0,3,0,63,0.383333333333333,63,0
4484,0,0,7,0,274,1.66666666666667,274,0
4485,0,2,4,6,349,1.5,245,104
4486,0,0,5,0,301,1.83333333333333,301,0
4487,0,0,4,0,214,1.3,214,0
4488,0,0,5,1,304,1.85,303,1
4490,0,1,3,3,290,1.51666666666667,249,41
4491,0,0,0,7,73,0,0,73
4493,1,0,7,0,232,1.41666666666667,232,0
4494,2,0,2,14,291,1.41666666666667,232,59
4495,1,3,9,4,268,1.56666666666667,257,11
4496,1,0,2,10,193,0.35,57,136
4498,1,0,2,9,189,0.35,57,132
4499,3,1,0,7,42,0,0,42
4500,0,0,2,0,194,1.18333333333333,194,0
4501,0,0,5,0,216,1.31666666666667,216,0
4502,0,0,8,0,257,1.56666666666667,257,0
4503,0,0,8,0,164,1,164,0
4504,0,0,2,7,180,0.683333333333333,112,68
4505,0,0,6,0,531,3.23333333333333,531,0
4506,0,0,5,0,191,1.16666666666667,191,0
4507,0,0,2,0,85,0.516666666666667,85,0
4508,0,0,2,9,385,1.71666666666667,282,103
4509,0,0,4,2,225,1.33333333333333,219,6
4510,0,0,0,15,72,0,0,72
4511,0,1,1,0,210,1.28333333333333,210,0
4513,0,3,4,5,297,1.6,263,34
4514,0,0,7,0,289,1.75,289,0
4515,0,0,2,10,201,0.383333333333333,63,138
4516,0,0,1,7,75,0.233333333333333,38,37
4517,10,2,0,20,237,0,0,237
4518,4,0,0,13,113,0,0,113
4519,0,0,5,1,349,2.1,345,4
4520,0,1,3,2,309,1.61666666666667,265,44
4521,7,21,5,7,695,4.11666666666667,675,20
4522,0,0,2,0,137,0.833333333333333,137,0
4523,0,0,2,0,588,3.58333333333333,588,0
4524,1,9,7,3,472,2.83333333333333,465,7
4525,2,2,6,8,232,1.23333333333333,203,29
4526,0,0,7,0,552,3.36666666666667,552,0
4527,0,0,6,0,375,2.28333333333333,375,0
4528,0,0,2,0,93,0.566666666666667,93,0
4529,0,0,6,0,450,2.75,450,0
4530,1,12,11,1,649,3.95,647,2
4531,0,0,3,3,105,0.583333333333333,96,9
4532,1,3,0,6,74,0,0,74
4533,0,1,4,2,368,2.11666666666667,347,21
4534,0,0,8,3,261,1.53333333333333,252,9
4535,1,0,2,12,220,0.35,57,163
4536,0,0,6,1,170,0.85,140,30
4537,0,0,0,17,128,0,0,128
4538,0,0,2,0,110,0.666666666666667,110,0
4539,1,0,3,14,197,1,165,32
4540,0,0,7,0,220,1.35,220,0
4541,0,0,5,2,243,1.43333333333333,235,8
4542,1,15,9,3,570,3.45,565,5
4543,0,0,2,0,60,0.366666666666667,60,0
4544,0,0,0,8,92,0,0,92
4545,2,0,1,18,197,0.4,66,131
4546,0,0,1,11,114,0.183333333333333,30,84
4547,0,0,0,9,63,0,0,63
4548,4,0,12,0,1091,6.65,1091,0
4549,0,2,1,12,195,0.6,98,97
4550,0,3,3,8,395,1.48333333333333,243,152
4551,4,1,2,13,478,1.83333333333333,301,177
4552,5,0,0,13,52,0,0,52
4553,0,0,2,0,331,2.01666666666667,331,0
4554,0,0,2,8,187,0.716666666666667,117,70
4555,0,0,3,3,304,1.4,229,75
4556,0,0,2,0,393,2.4,393,0
4557,1,0,0,17,95,0,0,95
4558,0,0,3,2,97,0.55,90,7
4559,3,2,0,5,45,0,0,45
4560,0,0,3,0,186,1.13333333333333,186,0
4561,0,0,9,3,205,1.2,196,9
4562,0,2,8,4,559,3.03333333333333,497,62
4563,0,17,7,3,658,3.93333333333333,646,12
4565,0,0,2,0,140,0.85,140,0
4566,0,6,9,4,913,5.51666666666667,904,9
4567,1,0,1,10,118,0.05,8,110
4568,0,0,8,0,284,1.73333333333333,284,0
4569,0,14,7,0,615,3.75,615,0
4570,0,4,6,4,1286,7.75,1272,14
4571,0,0,0,9,80,0,0,80
4572,4,1,0,11,80,0,0,80
4574,2,4,0,13,89,0,0,89
4575,6,0,2,9,337,1.8,295,42
4576,0,0,4,0,315,1.91666666666667,315,0
4577,0,0,1,15,139,0.583333333333333,96,43
4579,3,4,0,14,146,0,0,146
4580,0,3,5,3,462,2.8,459,3
4581,0,0,1,7,113,0.25,41,72
4582,1,1,0,3,88,0,0,88
4583,0,0,5,0,213,1.3,213,0
4584,0,0,4,0,301,1.83333333333333,301,0
4585,0,0,1,0,109,0.666666666666667,109,0
4586,1,1,8,3,303,1.81666666666667,297,6
4587,0,10,4,0,279,1.7,279,0
4589,0,0,12,4,297,1.73333333333333,284,13
4590,8,0,8,0,435,2.65,435,0
4591,0,8,9,1,894,5.43333333333333,892,2
4592,1,0,1,15,219,0.716666666666667,118,101
4595,0,0,3,0,536,3.26666666666667,536,0
4596,11,0,8,0,695,4.25,695,0
4597,0,0,5,0,372,2.26666666666667,372,0
4598,0,0,2,0,254,1.55,254,0
4600,5,0,0,14,103,0,0,103
4601,0,0,7,0,233,1.41666666666667,233,0
4602,3,3,0,6,58,0,0,58
4603,1,0,4,0,287,1.75,287,0
4604,0,0,3,0,320,1.95,320,0
4605,0,0,4,0,156,0.95,156,0
4606,0,0,9,0,670,4.08333333333333,670,0
4607,0,1,5,2,146,0.866666666666667,142,4
4608,0,1,0,12,128,0,0,128
4609,12,0,7,0,338,2.05,338,0
4610,0,0,8,0,377,2.3,377,0
4611,4,0,0,11,60,0,0,60
4612,3,0,1,0,104,0.633333333333333,104,0
4613,1,0,0,15,97,0,0,97
4614,0,0,8,0,280,1.7,280,0
4615,0,0,5,0,290,1.76666666666667,290,0
4616,0,0,6,1,198,1.18333333333333,195,3
4617,0,0,2,3,46,0.216666666666667,36,10
4618,0,0,4,0,254,1.55,254,0
4619,0,0,5,0,176,1.06666666666667,176,0
4620,0,0,3,0,287,1.75,287,0
4621,0,0,5,1,381,2.31666666666667,380,1
4622,0,0,4,3,143,0.833333333333333,137,6
4623,0,0,3,0,131,0.8,131,0
4624,3,1,0,13,193,0,0,193
4625,0,0,1,0,142,0.866666666666667,142,0
4626,0,0,6,0,259,1.58333333333333,259,0
4627,0,0,2,0,301,1.83333333333333,301,0
4629,1,0,2,11,200,0.35,57,143
4630,0,0,4,0,382,2.33333333333333,382,0
4631,0,3,4,4,292,1.5,246,46
4632,0,0,5,0,131,0.8,131,0
4633,0,8,11,2,1287,7.83333333333333,1284,3
4634,0,0,2,0,311,1.9,311,0
4635,0,0,2,12,449,1.71666666666667,282,167
4636,2,0,2,13,428,1.61666666666667,265,163
4637,5,4,0,12,117,0,0,117
4638,0,0,2,10,177,0.35,57,120
4639,0,0,4,0,281,1.71666666666667,281,0
4640,0,1,5,2,551,3.33333333333333,546,5
4641,1,2,0,15,143,0,0,143
4642,0,0,0,14,44,0,0,44
4643,4,2,0,15,117,0,0,117
4645,0,0,6,0,178,1.08333333333333,178,0
4646,4,0,0,13,59,0,0,59
4648,0,0,4,0,246,1.5,246,0
4649,3,0,1,12,221,0.816666666666667,134,87
4650,0,0,8,0,641,3.91666666666667,641,0
4651,0,0,4,4,245,1.38333333333333,228,17
4653,0,1,0,11,112,0,0,112
4654,2,0,1,13,279,0.833333333333333,137,142
4655,7,0,9,0,585,3.56666666666667,585,0
4656,0,0,1,0,284,1.73333333333333,284,0
4658,1,0,3,12,521,2.3,378,143
4659,0,0,0,10,87,0,0,87
4660,0,0,0,12,110,0,0,110
4661,3,11,6,2,368,2.2,360,8
4662,0,0,2,0,151,0.916666666666667,151,0
4663,0,0,2,4,156,0.85,140,16
4665,2,3,0,13,96,0,0,96
4666,0,0,0,9,107,0,0,107
4667,0,3,4,3,522,3.13333333333333,514,8
4668,0,0,3,0,776,4.73333333333333,776,0
4669,0,0,5,3,151,0.866666666666667,142,9
4670,0,0,7,0,279,1.7,279,0
4671,0,0,2,0,457,2.78333333333333,457,0
4672,0,0,6,2,168,1,164,4
4673,0,2,0,5,64,0,0,64
4674,0,0,1,0,273,1.66666666666667,273,0
4675,0,0,7,0,381,2.31666666666667,381,0
4676,6,0,9,0,675,4.11666666666667,675,0
4677,1,2,4,5,191,1.03333333333333,169,22
4678,0,0,6,0,588,3.58333333333333,588,0
4679,0,0,6,1,220,1.33333333333333,217,3
4680,0,12,9,1,904,5.5,902,2
4681,3,0,1,12,296,0.9,148,148
4682,0,0,6,0,241,1.46666666666667,241,0
4683,6,2,1,12,205,0.816666666666667,134,71
4684,0,0,7,0,629,3.83333333333333,629,0
4685,0,0,3,0,164,1,164,0
4686,8,4,0,11,121,0,0,121
4687,0,0,0,10,110,0,0,110
4688,0,0,5,0,402,2.45,402,0
4689,0,0,5,1,347,2.1,344,3
4690,1,0,1,9,152,0.183333333333333,30,122
4691,0,0,3,1,89,0.533333333333333,88,1
4692,0,0,0,8,79,0,0,79
4694,0,0,0,8,70,0,0,70
4695,5,0,10,0,694,4.23333333333333,694,0
4697,0,0,1,0,115,0.7,115,0
4698,2,3,6,9,516,2.56666666666667,420,96
4699,0,0,3,3,94,0.516666666666667,85,9
4700,0,0,3,0,332,2.01666666666667,332,0
4701,0,0,3,7,218,0.95,156,62
4702,0,0,4,6,330,1.75,287,43
4703,0,0,8,0,561,3.41666666666667,561,0
4704,0,4,3,2,91,0.533333333333333,87,4
4705,0,0,0,10,77,0,0,77
4706,0,0,2,1,149,0.9,148,1
4707,0,0,1,0,235,1.43333333333333,235,0
4709,0,0,3,0,254,1.55,254,0
4710,1,2,0,9,83,0,0,83
4711,0,0,8,0,329,2,329,0
4712,4,1,0,16,112,0,0,112
4713,4,0,9,0,601,3.65,601,0
4714,0,1,8,3,270,1.61666666666667,264,6
4715,1,1,3,2,79,0.466666666666667,76,3
4716,1,12,8,0,421,2.56666666666667,421,0
4717,0,0,1,0,227,1.38333333333333,227,0
4718,3,0,3,12,495,2.3,378,117
4719,1,2,0,8,117,0,0,117
4720,4,0,1,12,216,0.816666666666667,134,82
4721,0,0,2,0,44,0.266666666666667,44,0
4722,0,1,2,6,167,0.783333333333333,128,39
4723,4,1,1,13,227,0.816666666666667,134,93
4724,0,0,1,2,160,0.933333333333333,153,7
4725,3,0,0,12,80,0,0,80
4726,0,2,2,4,243,1.41666666666667,233,10
4727,0,1,1,10,182,0.816666666666667,134,48
4728,0,0,4,0,279,1.7,279,0
4729,0,1,6,3,400,2.28333333333333,374,26
4730,0,0,4,0,495,3.01666666666667,495,0
4731,4,0,11,0,1027,6.26666666666667,1027,0
4732,0,0,4,0,347,2.11666666666667,347,0
4733,0,0,8,3,427,2.46666666666667,405,22
4734,0,0,1,0,328,2,328,0
4735,0,0,6,8,413,2.06666666666667,340,73
4736,0,0,4,1,504,3.05,500,4
4737,0,0,6,0,179,1.08333333333333,179,0
4738,0,0,4,1,130,0.783333333333333,128,2
4739,0,0,2,2,182,0.883333333333333,145,37
4740,0,0,2,1,103,0.566666666666667,93,10
4742,7,4,0,8,155,0,0,155
4743,3,0,0,13,141,0,0,141
4744,0,8,8,0,683,4.16666666666667,683,0
4745,0,0,4,3,285,1.68333333333333,277,8
4746,0,16,9,0,483,2.95,483,0
4747,0,0,2,0,151,0.916666666666667,151,0
4748,0,0,2,0,219,1.33333333333333,219,0
4750,1,9,11,0,646,3.93333333333333,646,0
4751,1,0,0,14,60,0,0,60
4752,0,0,2,0,169,1.03333333333333,169,0
4753,0,10,8,1,387,2.35,385,2
4754,0,0,7,0,700,4.26666666666667,700,0
4755,0,0,7,0,292,1.78333333333333,292,0
4757,4,0,2,11,199,0.35,57,142
4758,0,0,5,0,394,2.4,394,0
4759,0,0,4,0,181,1.1,181,0
4760,0,0,3,1,432,2.61666666666667,429,3
4761,0,0,1,13,151,0.55,90,61
4763,0,2,9,2,657,3.98333333333333,653,4
4764,0,0,3,2,125,0.733333333333333,121,4
4765,0,0,1,14,204,0.466666666666667,77,127
4766,4,4,1,10,172,0.55,90,82
4767,0,0,1,0,107,0.65,107,0
4768,1,0,0,12,144,0,0,144
4769,0,0,2,0,320,1.95,320,0
4770,0,0,7,0,500,3.05,500,0
4771,0,0,1,0,161,0.983333333333333,161,0
4772,6,4,0,9,191,0,0,191
4773,4,4,0,8,73,0,0,73
4774,0,3,0,12,80,0,0,80
4775,2,0,2,10,278,1.4,230,48
4776,0,0,4,0,508,3.1,508,0
4777,1,0,1,15,350,1.28333333333333,210,140
4778,0,0,6,2,190,1.11666666666667,184,6
4779,0,0,4,0,184,1.11666666666667,184,0
4780,0,0,1,0,271,1.65,271,0
4781,0,0,3,4,196,1.01666666666667,166,30
4782,2,10,8,1,422,2.56666666666667,420,2
4783,0,0,5,1,430,2.6,426,4
4784,0,0,12,0,1098,6.7,1098,0
4785,2,0,1,12,86,0.266666666666667,44,42
4786,0,0,2,6,151,0.516666666666667,85,66
4787,2,7,3,12,217,0.916666666666667,150,67
4789,3,4,0,9,85,0,0,85
4790,0,0,4,1,183,1.08333333333333,178,5
4791,0,0,1,4,83,0.316666666666667,52,31
4793,0,0,4,0,334,2.03333333333333,334,0
4794,4,0,1,9,208,1.1,180,28
4795,5,0,1,17,258,0.816666666666667,134,124
4796,0,0,4,3,109,0.616666666666667,102,7
4797,0,0,5,0,305,1.86666666666667,305,0
4798,0,0,7,0,462,2.81666666666667,462,0
4799,0,0,7,0,867,5.28333333333333,867,0
4800,0,0,12,0,650,3.96666666666667,650,0
4801,2,7,5,5,592,3.18333333333333,522,70
4802,0,9,6,5,1067,6.38333333333333,1047,20
4803,1,4,10,5,926,5.6,919,7
4804,0,0,5,0,435,2.65,435,0
4805,0,4,4,2,1135,6.9,1132,3
4806,0,0,9,0,522,3.18333333333333,522,0
4807,2,10,9,2,555,3.36666666666667,553,2
4808,0,0,5,0,585,3.56666666666667,585,0
4809,0,19,16,8,1836,11.0833333333333,1817,19
4810,0,0,8,0,400,2.43333333333333,400,0
4811,3,17,22,1,2511,15.3,2510,1
4812,0,2,4,0,426,2.6,426,0
4813,1,6,4,3,846,5.11666666666667,839,7
4814,0,2,7,0,434,2.65,434,0
4815,0,9,17,2,1931,11.75,1929,2
4816,0,0,3,0,426,2.6,426,0
4817,0,1,7,0,460,2.8,460,0
4818,0,14,17,2,1930,11.7,1920,10
4819,8,10,7,13,2359,14.1666666666667,2323,36
4820,0,0,1,0,68,0.416666666666667,68,0
4822,2,6,7,0,363,2.21666666666667,363,0
4823,0,7,7,2,710,4.31666666666667,708,2
4824,2,6,10,0,663,4.03333333333333,663,0
4825,1,2,7,0,609,3.71666666666667,609,0
4826,0,11,13,0,1858,11.3333333333333,1858,0
4828,3,7,14,5,880,5.28333333333333,868,12
4829,4,13,6,9,2255,13.5833333333333,2226,29
4830,0,1,12,0,351,2.13333333333333,351,0
4831,0,0,5,0,281,1.71666666666667,281,0
4832,0,1,5,0,275,1.68333333333333,275,0
4833,0,0,6,0,425,2.58333333333333,425,0
4834,2,1,7,0,641,3.9,641,0
4835,3,14,7,11,729,4.23333333333333,693,36
4836,1,3,6,0,473,2.88333333333333,473,0
4837,0,7,22,3,1754,10.65,1747,7
4838,0,1,7,0,509,3.1,509,0
4840,0,1,8,0,902,5.5,902,0
4841,0,7,6,0,240,1.46666666666667,240,0
4842,0,15,9,6,1004,6.05,993,11
4843,0,10,6,6,1994,12.1,1984,10
4844,0,1,10,0,576,3.51666666666667,576,0
4845,3,10,5,8,2325,14.0333333333333,2301,24
4847,2,8,7,1,612,3.71666666666667,611,1
4848,4,11,12,4,733,4.43333333333333,727,6
4850,0,1,6,0,365,2.23333333333333,365,0
4851,3,10,5,14,2408,14.2833333333333,2342,66
4852,2,7,7,1,368,2.23333333333333,367,1
4853,1,9,4,3,388,2.3,377,11
4854,3,11,10,5,568,3.4,560,8
4855,1,6,5,3,1635,9.93333333333333,1628,7
4856,0,3,6,1,496,3.01666666666667,495,1
4857,0,0,13,0,551,3.35,551,0
4858,0,0,0,1,61,0,0,61
4859,0,0,4,0,433,2.65,433,0
4860,0,0,4,0,247,1.5,247,0
4861,2,5,6,2,1745,10.6333333333333,1743,2
4862,0,1,4,0,355,2.16666666666667,355,0
4863,5,5,0,16,165,0,0,165
4864,2,0,5,1,197,1.2,196,1
4865,3,13,13,3,793,4.8,787,6
4866,3,10,5,5,295,1.75,287,8
4868,0,0,5,2,466,2.78333333333333,457,9
4869,1,0,2,13,232,0.35,57,175
4870,0,0,3,5,224,1.28333333333333,210,14
4871,0,10,10,6,1307,7.83333333333333,1287,20
4873,2,1,4,5,579,3.33333333333333,547,32
4874,0,4,4,3,913,5.53333333333333,907,6
4875,0,9,7,11,444,2.6,425,19
4876,0,1,7,0,535,3.26666666666667,535,0
4877,1,4,5,2,789,4.8,787,2
4878,0,11,5,6,229,1.26666666666667,207,22
4879,0,12,7,6,893,5.36666666666667,881,12
4880,0,11,7,8,845,5.03333333333333,826,19
4881,1,5,9,0,347,2.11666666666667,347,0
4882,0,2,7,1,370,2.25,368,2
4883,5,13,12,16,1507,8.88333333333333,1456,51
4884,0,0,6,0,681,4.15,681,0
4885,0,11,14,12,1383,8.28333333333333,1359,24
4886,3,13,12,10,1153,6.81666666666667,1119,34
4887,0,4,3,5,954,5.66666666666667,930,24
4888,0,4,4,4,786,4.71666666666667,774,12
4889,0,0,4,0,506,3.08333333333333,506,0
4890,1,18,19,9,1148,6.88333333333333,1132,16
4891,0,1,10,0,375,2.28333333333333,375,0
4892,0,3,4,1,827,5.03333333333333,826,1
4893,0,1,8,0,669,4.08333333333333,669,0
4894,1,4,5,4,602,3.63333333333333,597,5
4895,0,0,9,0,560,3.41666666666667,560,0
4896,1,10,7,4,902,5.43333333333333,891,11
4897,0,1,7,0,327,2,327,0
4898,4,16,8,16,1077,6.13333333333333,1005,72
4900,1,4,9,3,1182,7.13333333333333,1170,12
4901,1,12,5,13,1054,6.23333333333333,1022,32
4902,0,4,10,0,518,3.16666666666667,518,0
4904,0,4,10,0,265,1.61666666666667,265,0
4905,0,2,9,0,398,2.43333333333333,398,0
4906,0,1,12,0,558,3.4,558,0
4907,2,12,9,6,1202,7.2,1180,22
4908,0,3,11,0,392,2.38333333333333,392,0
4909,0,0,7,0,290,1.76666666666667,290,0
4910,0,7,3,4,461,2.73333333333333,448,13
4911,1,13,5,4,1775,10.7166666666667,1758,17
4912,0,0,5,0,496,3.03333333333333,496,0
4913,0,0,6,0,548,3.35,548,0
4914,2,3,13,0,547,3.31666666666667,547,0
4915,0,0,5,0,349,2.13333333333333,349,0
4916,1,2,13,0,496,3.01666666666667,496,0
4917,0,2,12,0,739,4.5,739,0
4918,0,3,13,0,634,3.86666666666667,634,0
4919,0,3,9,0,695,4.23333333333333,695,0
4920,0,0,8,0,564,3.43333333333333,564,0
4921,0,0,6,0,403,2.45,403,0
4922,2,9,4,7,805,4.8,787,18
4923,0,0,5,0,209,1.28333333333333,209,0
4924,14,15,25,16,4708,28.2666666666667,4635,73
4925,0,0,6,0,306,1.86666666666667,306,0
4926,5,12,15,3,1557,9.45,1550,7
4927,6,13,15,32,3246,17.8833333333333,2933,313
4928,0,3,6,0,167,1.01666666666667,167,0
4929,4,9,29,10,3906,23.6333333333333,3875,31
4930,0,0,4,0,117,0.716666666666667,117,0
4931,3,24,8,29,733,2.53333333333333,415,318
4932,2,3,0,7,38,0,0,38
4934,1,2,5,1,435,2.63333333333333,431,4
4936,0,1,7,0,237,1.45,237,0
4937,0,8,3,8,372,1.86666666666667,307,65
4939,3,11,31,21,5247,30.7166666666667,5036,211
4941,6,4,3,4,183,0.9,147,36
4943,0,4,6,1,416,2.46666666666667,404,12
4944,0,0,5,0,89,0.55,89,0
4945,0,0,6,0,442,2.68333333333333,442,0
4946,10,3,1,18,441,1.81666666666667,298,143
4947,3,8,6,5,443,2.45,401,42
4948,9,18,7,39,2362,11.85,1943,419
4949,0,0,7,0,365,2.23333333333333,365,0
4950,0,2,9,0,337,2.05,337,0
4951,0,0,6,0,449,2.73333333333333,449,0
4952,0,2,6,0,203,1.23333333333333,203,0
4954,0,9,0,13,141,0,0,141
4955,0,0,6,0,513,3.13333333333333,513,0
4956,0,0,5,0,253,1.55,253,0
4957,6,9,9,7,481,2.78333333333333,456,25
4959,2,23,7,32,2528,13.05,2141,387
4960,7,13,18,16,3627,21.5833333333333,3541,86
4961,0,2,12,0,511,3.11666666666667,511,0
4962,0,0,6,0,249,1.51666666666667,249,0
4963,3,21,40,11,5116,30.6333333333333,5018,98
4964,9,16,14,15,1516,8.36666666666667,1372,144
4965,2,9,15,4,976,5.88333333333333,965,11
4966,11,24,5,33,1598,7.63333333333333,1251,347
4967,0,0,7,0,254,1.55,254,0
4968,5,22,39,14,5702,34.45,5647,55
4969,0,0,7,0,399,2.43333333333333,399,0
4970,0,0,9,0,458,2.78333333333333,458,0
4971,5,6,12,4,963,5.73333333333333,941,22
4972,0,2,4,3,196,1.03333333333333,170,26
4973,0,0,7,0,483,2.95,483,0
4974,0,1,11,0,780,4.75,780,0
4975,0,0,6,0,585,3.56666666666667,585,0
4976,10,8,0,37,436,0,0,436
4977,0,0,6,0,329,2,329,0
4978,7,1,7,13,1728,10.1,1656,72
4979,3,13,16,10,2158,12.75,2089,69
4980,0,0,9,0,275,1.68333333333333,275,0
4981,0,0,6,0,125,0.766666666666667,125,0
4982,0,2,5,0,435,2.65,435,0
4983,0,0,7,0,553,3.36666666666667,553,0
4984,0,0,4,0,153,0.933333333333333,153,0
4985,0,0,6,0,399,2.43333333333333,399,0
4986,9,3,4,13,590,2.53333333333333,416,174
4991,0,0,17,0,689,4.2,689,0
4992,0,11,12,4,1046,6.26666666666667,1029,17
4993,0,7,11,0,1201,7.33333333333333,1201,0
4994,2,4,4,16,781,4.16666666666667,684,97
4995,0,0,25,0,818,5,818,0
4996,4,12,11,16,1630,9.58333333333333,1572,58
4997,3,0,8,0,461,2.81666666666667,461,0
4998,0,5,10,2,650,3.93333333333333,644,6
5000,0,0,10,0,330,2.01666666666667,330,0
5002,0,0,7,0,270,1.65,270,0
5003,7,4,12,5,1735,10.2666666666667,1684,51
5005,0,0,12,0,293,1.78333333333333,293,0
5006,1,4,11,3,768,4.65,762,6
5007,0,0,7,0,217,1.33333333333333,217,0
5008,0,9,9,8,704,4.15,680,24
5009,0,5,10,0,983,6,983,0
5010,0,9,11,1,1027,6.23333333333333,1023,4
5011,0,0,11,0,286,1.75,286,0
5012,3,7,14,24,2399,13.85,2271,128
5013,0,0,8,0,156,0.95,156,0
5014,0,0,12,0,915,5.58333333333333,915,0
5015,14,19,7,24,2069,11.95,1961,108
5016,2,0,9,1,955,5.8,952,3
5017,2,18,8,13,946,5.51666666666667,904,42
5019,0,0,12,0,263,1.6,263,0
5020,0,5,11,3,537,3.25,530,7
5021,0,7,11,1,794,4.83333333333333,793,1
5022,2,11,12,3,1303,7.91666666666667,1297,6
5023,0,5,7,6,440,2.6,426,14
5024,1,11,9,7,768,4.58333333333333,752,16
5025,6,0,9,7,845,5.1,837,8
5026,0,0,13,0,388,2.36666666666667,388,0
5027,5,7,23,8,3364,20.2333333333333,3319,45
5028,0,0,9,0,298,1.81666666666667,298,0
5029,0,3,7,2,505,3.05,501,4
5030,0,8,16,1,1634,9.96666666666667,1633,1
5031,0,0,10,0,196,1.2,196,0
5032,0,10,9,6,561,3.36666666666667,552,9
5033,0,8,7,0,782,4.76666666666667,782,0
5034,6,13,4,31,1874,9.93333333333333,1629,245
5035,1,9,14,0,1571,9.58333333333333,1571,0
5036,0,12,16,7,812,4.83333333333333,792,20
5038,0,0,7,0,241,1.46666666666667,241,0
5039,5,16,9,17,1221,6.75,1107,114
5041,1,0,9,0,821,5,821,0
5042,6,1,16,8,2172,13.0166666666667,2134,38
5044,0,10,12,1,1804,11,1803,1
5045,0,6,9,1,628,3.81666666666667,627,1
5046,0,0,1,17,240,0.166666666666667,27,213
5047,0,0,5,1,297,1.8,296,1
5048,6,3,0,10,69,0,0,69
5049,6,3,0,9,216,0,0,216
5050,0,0,7,0,973,5.93333333333333,973,0
5051,0,0,4,0,168,1.01666666666667,168,0
5052,0,0,6,0,372,2.26666666666667,372,0
5053,0,0,2,0,229,1.4,229,0
5054,0,0,1,17,190,0.1,16,174
5056,0,0,3,1,67,0.366666666666667,60,7
5057,0,0,9,0,820,5,820,0
5058,0,1,5,2,277,1.63333333333333,267,10
5059,0,0,7,1,306,1.76666666666667,288,18
5060,1,0,8,0,983,6,983,0
5061,2,2,0,11,72,0,0,72
5062,0,0,5,11,449,2.4,393,56
5063,0,0,7,0,897,5.46666666666667,897,0
5064,0,9,9,0,389,2.36666666666667,389,0
5065,5,0,0,15,145,0,0,145
5066,0,0,0,8,243,0,0,243
5067,0,0,5,0,618,3.76666666666667,618,0
5068,0,0,2,2,81,0.266666666666667,44,37
5069,3,1,0,13,127,0,0,127
5070,1,0,0,14,66,0,0,66
5073,0,0,8,1,788,4.8,787,1
5074,3,2,0,14,227,0,0,227
5075,3,4,0,5,36,0,0,36
5076,0,0,3,0,126,0.766666666666667,126,0
5077,0,7,3,0,145,0.883333333333333,145,0
5078,0,0,1,0,216,1.31666666666667,216,0
5079,2,5,0,9,144,0,0,144
5080,1,0,6,4,180,1.05,172,8
5081,3,0,0,11,149,0,0,149
5082,1,1,1,3,174,1.01666666666667,167,7
5084,0,0,0,5,35,0,0,35
5085,0,0,2,0,186,1.13333333333333,186,0
5086,5,0,0,12,31,0,0,31
5087,4,2,0,7,163,0,0,163
5088,4,3,0,16,190,0,0,190
5089,0,0,5,3,404,2.4,393,11
5090,1,1,5,4,146,0.833333333333333,136,10
5091,0,0,0,10,92,0,0,92
5092,4,3,8,3,898,5.4,886,12
5093,0,0,4,3,497,2.58333333333333,423,74
5094,0,0,6,0,798,4.86666666666667,798,0
5095,0,0,4,1,199,1.16666666666667,192,7
5097,0,0,0,10,61,0,0,61
5098,1,0,3,14,263,0.533333333333333,87,176
5099,2,2,0,11,131,0,0,131
5100,0,0,2,9,145,0.416666666666667,68,77
5101,0,0,1,0,98,0.6,98,0
5102,1,0,0,9,17,0,0,17
5103,0,8,3,0,144,0.883333333333333,144,0
5104,0,0,6,0,394,2.4,394,0
5105,0,0,2,0,88,0.533333333333333,88,0
5106,0,0,1,1,51,0.3,49,2
5108,0,0,4,0,320,1.95,320,0
5109,0,1,3,1,111,0.633333333333333,104,7
5110,0,0,2,2,202,1,164,38
5111,0,0,3,0,153,0.933333333333333,153,0
5112,0,0,6,0,634,3.86666666666667,634,0
5113,3,1,2,10,377,1.48333333333333,244,133
5114,5,0,0,12,88,0,0,88
5115,0,7,11,1,885,5.38333333333333,883,2
5116,0,0,8,5,263,1.4,228,35
5117,0,0,2,0,139,0.85,139,0
5118,0,0,3,0,199,1.21666666666667,199,0
5119,0,0,5,0,544,3.31666666666667,544,0
5120,0,0,2,0,309,1.88333333333333,309,0
5121,0,0,5,0,569,3.46666666666667,569,0
5122,3,3,0,13,188,0,0,188
5123,0,0,5,4,462,2.71666666666667,446,16
5124,1,0,3,10,330,1.63333333333333,268,62
5125,4,6,0,5,42,0,0,42
5126,6,3,0,15,152,0,0,152
5127,0,8,4,0,170,1.03333333333333,170,0
5128,0,0,6,0,496,3.01666666666667,496,0
5129,0,0,0,3,60,0,0,60
5130,0,0,8,0,650,3.96666666666667,650,0
5131,0,1,8,1,293,1.68333333333333,275,18
5132,0,0,7,0,536,3.26666666666667,536,0
5133,3,0,1,13,171,0.816666666666667,134,37
5134,0,0,2,0,224,1.36666666666667,224,0
5135,0,10,6,0,413,2.51666666666667,413,0
5136,1,0,0,15,175,0,0,175
5137,0,0,1,14,285,0.9,148,137
5138,0,5,4,0,257,1.56666666666667,257,0
5139,0,0,4,2,331,1.91666666666667,315,16
5140,4,0,0,13,67,0,0,67
5141,1,0,7,1,680,4.08333333333333,670,10
5142,1,0,6,2,251,1.51666666666667,248,3
5143,0,0,1,0,208,1.26666666666667,208,0
5144,0,0,10,4,366,2.06666666666667,339,27
5145,0,0,2,10,182,0.35,57,125
5146,0,0,5,2,314,1.88333333333333,308,6
5147,4,6,0,8,118,0,0,118
5150,1,2,0,16,181,0,0,181
5151,0,6,4,0,239,1.45,239,0
5152,0,1,5,0,125,0.766666666666667,125,0
5153,0,0,5,0,344,2.1,344,0
5154,1,2,0,6,69,0,0,69
5155,3,0,1,14,237,0.666666666666667,109,128
5156,0,0,0,8,43,0,0,43
5157,0,0,1,0,107,0.65,107,0
5158,0,0,4,1,329,1.83333333333333,302,27
5159,0,0,0,10,296,0,0,296
5161,3,2,0,10,78,0,0,78
5162,0,0,0,8,67,0,0,67
5163,0,0,3,4,322,1.85,303,19
5164,8,8,0,13,80,0,0,80
5165,0,0,0,2,15,0,0,15
5166,0,0,1,0,235,1.43333333333333,235,0
5167,2,1,0,9,180,0,0,180
5168,0,1,4,4,344,2.01666666666667,331,13
5169,2,2,1,14,185,0.816666666666667,134,51
5170,0,0,3,3,210,1.23333333333333,203,7
5171,0,0,2,10,159,0.35,57,102
5172,0,0,1,0,172,1.05,172,0
5173,3,1,0,16,129,0,0,129
5174,3,0,0,12,143,0,0,143
5175,2,2,0,11,135,0,0,135
5177,1,2,2,13,203,0.35,57,146
5178,2,0,0,13,89,0,0,89
5179,1,6,4,2,294,1.76666666666667,290,4
5180,1,0,1,15,198,0.166666666666667,27,171
5181,2,3,0,7,48,0,0,48
5182,2,2,0,13,226,0,0,226
5183,0,0,1,0,104,0.633333333333333,104,0
5184,1,0,3,12,377,1.81666666666667,298,79
5185,5,0,0,15,69,0,0,69
5186,0,0,3,0,150,0.916666666666667,150,0
5188,0,1,10,0,1084,6.6,1084,0
5189,0,10,7,0,430,2.61666666666667,430,0
5190,0,0,1,1,40,0.233333333333333,38,2
5192,0,0,1,0,251,1.53333333333333,251,0
5193,0,0,1,15,163,0.466666666666667,77,86
5194,6,1,0,10,144,0,0,144
5195,0,0,1,1,70,0.416666666666667,68,2
5196,0,0,5,0,533,3.25,533,0
5197,0,0,4,0,300,1.83333333333333,300,0
5198,0,0,4,0,156,0.95,156,0
5199,0,0,4,0,449,2.73333333333333,449,0
5200,3,0,0,12,103,0,0,103
5201,11,10,0,15,175,0,0,175
5202,1,0,6,0,392,2.4,392,0
5203,0,0,3,0,101,0.616666666666667,101,0
5205,0,0,0,7,52,0,0,52
5206,1,0,0,12,67,0,0,67
5207,2,6,0,10,100,0,0,100
5208,4,0,0,12,97,0,0,97
5209,0,0,4,0,68,0.416666666666667,68,0
5210,8,2,1,16,396,1.26666666666667,208,188
5211,0,2,4,1,171,1.03333333333333,169,2
5212,0,1,6,1,772,4.7,771,1
5213,0,1,4,1,324,1.96666666666667,323,1
5214,0,0,4,0,306,1.86666666666667,306,0
5215,1,0,7,1,566,3.45,565,1
5216,1,0,6,1,173,0.9,146,27
5217,0,0,6,1,296,1.8,294,2
5218,0,1,4,6,372,1.35,221,151
5219,0,5,2,0,63,0.383333333333333,63,0
5220,1,0,0,9,100,0,0,100
5221,0,0,5,2,293,1.76666666666667,290,3
5223,1,2,0,4,65,0,0,65
5224,0,0,2,0,323,1.96666666666667,323,0
5225,4,3,0,8,86,0,0,86
5226,0,0,4,1,239,1.43333333333333,235,4
5228,0,3,4,7,145,0.783333333333333,129,16
5229,0,0,1,10,48,0.05,8,40
5230,2,0,0,12,99,0,0,99
5231,0,0,2,0,328,2,328,0
5232,0,6,7,0,372,2.26666666666667,372,0
5233,0,0,2,9,81,0.116666666666667,19,62
5234,1,0,4,4,180,0.883333333333333,144,36
5235,0,0,1,0,77,0.466666666666667,77,0
5236,0,0,5,0,382,2.33333333333333,382,0
5237,0,7,2,2,148,0.883333333333333,145,3
5238,2,2,0,8,123,0,0,123
5239,0,0,3,14,433,1.76666666666667,290,143
5240,1,3,0,12,186,0,0,186
5241,0,0,1,0,156,0.95,156,0
5242,0,0,2,0,429,2.61666666666667,429,0
5243,0,0,4,0,101,0.616666666666667,101,0
5244,1,0,6,8,224,0.733333333333333,121,103
5245,0,0,4,3,354,2.01666666666667,331,23
5246,0,9,3,0,126,0.766666666666667,126,0
5247,0,0,0,9,10,0,0,10
5248,1,4,0,14,189,0,0,189
5249,0,1,1,0,161,0.983333333333333,161,0
5250,0,0,2,11,142,0.35,57,85
5251,0,2,4,4,361,2.08333333333333,342,19
5252,0,0,1,0,180,1.1,180,0
5253,0,0,1,0,178,1.08333333333333,178,0
5254,2,3,10,8,326,1.75,287,39
5255,0,0,0,11,95,0,0,95
5256,4,6,0,7,93,0,0,93
5257,0,0,5,0,461,2.81666666666667,461,0
5258,5,1,0,10,93,0,0,93
5259,0,0,5,0,259,1.58333333333333,259,0
5260,0,0,2,1,173,1.03333333333333,169,4
5261,0,1,0,12,63,0,0,63
5262,0,0,6,0,289,1.76666666666667,289,0
5263,0,0,11,3,460,2.68333333333333,438,22
5264,0,0,0,7,52,0,0,52
5265,0,10,6,0,442,2.7,442,0
5266,0,0,5,0,574,3.5,574,0
5267,0,7,7,1,591,3.58333333333333,589,2
5268,0,0,2,0,235,1.43333333333333,235,0
5269,0,0,4,8,378,2.06666666666667,338,40
5270,0,0,3,1,145,0.85,140,5
5271,0,0,3,1,141,0.833333333333333,136,5
5272,0,0,7,1,587,3.53333333333333,579,8
5274,3,0,0,10,71,0,0,71
5275,0,1,0,13,114,0,0,114
5276,0,10,10,0,674,4.1,674,0
5278,0,2,0,4,31,0,0,31
5279,0,0,4,0,391,2.38333333333333,391,0
5280,4,1,9,5,307,1.78333333333333,292,15
5281,0,0,4,0,241,1.46666666666667,241,0
5282,1,1,2,9,399,2.1,344,55
5283,0,0,3,0,196,1.2,196,0
5284,4,5,0,14,123,0,0,123
5285,4,0,1,11,204,0.816666666666667,134,70
5286,9,10,0,17,248,0,0,248
5287,1,3,0,3,5,0,0,5
5288,0,1,4,1,278,1.66666666666667,274,4
5290,0,9,0,1,1,0,0,1
5291,1,9,3,2,198,1.18333333333333,195,3
5292,0,0,3,2,212,1.23333333333333,202,10
5293,0,0,5,8,113,0.4,66,47
5294,2,0,2,13,217,0.35,57,160
5295,1,3,0,7,129,0,0,129
5296,3,0,0,12,79,0,0,79
5297,0,0,5,2,383,2.26666666666667,372,11
5298,1,0,7,0,1173,7.15,1173,0
5299,0,0,5,1,229,1.38333333333333,227,2
5300,0,0,2,11,196,0.35,57,139
5301,0,0,1,11,120,0.183333333333333,30,90
5302,0,0,3,1,130,0.75,123,7
5303,0,5,5,1,235,1.41666666666667,233,2
5304,0,0,2,0,172,1.05,172,0
5305,2,1,0,15,231,0,0,231
5306,0,0,1,15,112,0.233333333333333,38,74
5307,0,0,0,9,69,0,0,69
5308,0,0,3,1,353,2.13333333333333,350,3
5309,8,11,0,13,163,0,0,163
5310,0,0,5,10,315,1.6,262,53
5311,0,0,6,0,695,4.23333333333333,695,0
5312,0,0,0,10,43,0,0,43
5313,0,0,3,0,998,6.08333333333333,998,0
5315,0,7,4,1,267,1.61666666666667,265,2
5317,2,0,1,14,212,0.183333333333333,30,182
5319,0,0,8,1,853,5.2,852,1
5320,1,0,6,0,260,1.58333333333333,260,0
5321,0,0,2,0,216,1.31666666666667,216,0
5322,0,0,4,0,347,2.11666666666667,347,0
5323,2,1,0,15,94,0,0,94
5324,0,8,4,0,259,1.58333333333333,259,0
5325,1,1,1,16,331,0.9,148,183
5326,0,0,3,2,268,1.55,254,14
5327,0,0,5,2,318,1.91666666666667,315,3
5328,0,0,1,0,197,1.2,197,0
5329,0,0,2,0,281,1.71666666666667,281,0
5330,1,0,2,12,217,0.35,57,160
5331,0,9,4,0,254,1.55,254,0
5332,6,8,0,12,135,0,0,135
5333,0,0,3,3,318,1.81666666666667,298,20
5334,0,1,12,2,475,2.86666666666667,468,7
5335,0,0,3,0,131,0.8,131,0
5337,1,0,1,13,193,0.766666666666667,126,67
5338,0,0,5,0,304,1.85,304,0
5339,2,7,0,12,129,0,0,129
5340,0,7,7,0,481,2.93333333333333,481,0
5341,1,0,3,2,88,0.333333333333333,54,34
5342,0,1,0,7,73,0,0,73
5343,3,3,0,8,123,0,0,123
5344,10,9,0,12,278,0,0,278
5345,0,0,2,2,52,0.283333333333333,46,6
5346,0,1,4,0,208,1.26666666666667,208,0
5347,4,3,0,7,91,0,0,91
5348,0,2,4,6,284,1.58333333333333,259,25
5349,1,1,8,6,356,1.91666666666667,315,41
5350,3,3,0,9,136,0,0,136
5351,2,1,7,8,265,1.41666666666667,232,33
5352,2,0,1,11,203,0.816666666666667,134,69
5353,0,0,5,0,434,2.65,434,0
5354,0,0,4,0,169,1.03333333333333,169,0
5355,1,0,0,13,74,0,0,74
5356,0,0,2,0,284,1.73333333333333,284,0
5357,6,4,0,8,169,0,0,169
5359,1,1,0,11,185,0,0,185
5360,1,2,8,2,1065,6.46666666666667,1062,3
5361,0,0,4,3,204,1.16666666666667,191,13
5362,2,0,8,4,189,1.11666666666667,182,7
5364,0,0,3,0,326,1.98333333333333,326,0
5365,4,0,1,17,161,0.2,33,128
5367,0,12,18,1,1649,10.05,1648,1
5369,1,0,12,1,1155,7.03333333333333,1154,1
5370,0,7,14,0,1086,6.61666666666667,1086,0
5371,3,2,31,2,3201,19.5,3198,3
5372,2,0,0,15,171,0,0,171
5373,1,0,2,12,218,0.35,57,161
5374,6,0,10,0,889,5.41666666666667,889,0
5375,0,1,9,0,376,2.3,376,0
5376,0,0,8,0,387,2.35,387,0
5377,0,0,3,3,318,1.6,262,56
5378,0,9,2,1,152,0.916666666666667,150,2
5379,0,0,2,0,189,1.15,189,0
5380,0,0,4,0,232,1.41666666666667,232,0
5381,3,2,25,2,1889,11.4666666666667,1882,7
5448,3,14,4,2,178,1.03333333333333,170,8
5449,0,0,1,2,31,0.166666666666667,27,4
5450,2,1,16,6,1474,8.83333333333333,1450,24
5451,0,0,2,0,139,0.85,139,0
5452,0,0,3,2,92,0.516666666666667,84,8
5453,0,0,2,0,52,0.316666666666667,52,0
5456,0,0,5,0,290,1.76666666666667,290,0
5458,3,6,19,10,2884,17.2833333333333,2833,51
5459,12,20,0,41,321,0,0,321
5463,0,0,0,1,2,0,0,2
5465,0,0,5,0,618,3.76666666666667,618,0
5466,0,0,6,0,262,1.6,262,0
5468,0,0,0,1,1,0,0,1
5469,2,0,0,15,78,0,0,78
5471,0,0,4,8,127,0.516666666666667,85,42
5472,3,0,0,19,83,0,0,83
5473,1,0,0,1,1,0,0,1
5474,0,0,11,0,391,2.38333333333333,391,0
5475,0,0,0,5,55,0,0,55
5476,1,17,8,1,609,3.66666666666667,603,6
5478,0,0,2,4,128,0.75,123,5
5479,2,2,0,14,131,0,0,131
5480,0,0,5,3,134,0.583333333333333,95,39
5481,0,1,4,2,281,1.66666666666667,274,7
5482,5,2,0,15,142,0,0,142
5483,4,1,0,14,180,0,0,180
5485,1,0,2,13,411,1.66666666666667,273,138
5487,0,1,4,2,327,1.95,320,7
5488,0,0,5,1,225,1.36666666666667,224,1
5489,0,0,4,1,185,0.966666666666667,158,27
5490,1,3,9,1,577,3.5,575,2
5491,2,4,0,5,36,0,0,36
5494,3,1,6,3,267,1.56666666666667,256,11
5497,0,0,0,4,31,0,0,31
5500,0,0,0,6,39,0,0,39
5501,3,0,0,14,94,0,0,94
5517,0,8,0,10,172,0,0,172
5518,3,0,4,11,291,1.31666666666667,215,76
5519,6,7,1,15,344,0.3,49,295
5520,0,0,6,0,826,5.03333333333333,826,0
5521,13,20,0,34,524,0,0,524
5522,0,0,13,0,1246,7.6,1246,0
5524,0,2,6,1,511,2.83333333333333,465,46
5525,0,0,4,10,904,4.05,663,241
5526,0,0,1,11,114,0.133333333333333,22,92
5527,0,0,2,12,220,0.333333333333333,55,165
5528,0,0,12,0,736,4.48333333333333,736,0
5529,1,2,0,9,179,0,0,179
5530,1,0,12,2,736,4.43333333333333,726,10
5532,0,0,6,0,432,2.63333333333333,432,0
5533,2,0,1,14,213,0.683333333333333,112,101
5534,4,8,0,12,122,0,0,122
5535,0,0,12,0,985,6,985,0
5536,0,0,11,0,879,5.36666666666667,879,0
5537,9,0,7,11,762,4.33333333333333,712,50
5538,0,0,8,0,679,4.15,679,0
5539,2,0,4,8,340,1.73333333333333,285,55
5540,0,0,10,0,928,5.65,928,0
5541,1,0,3,12,184,0.783333333333333,129,55
5542,2,0,2,11,336,1.36666666666667,225,111
5544,0,0,4,0,358,2.18333333333333,358,0
5545,3,4,0,11,175,0,0,175
5546,1,0,4,12,738,3.23333333333333,530,208
5547,0,0,7,1,719,4.38333333333333,718,1
5548,0,1,0,13,473,0,0,473
5549,0,0,4,7,556,2.23333333333333,367,189
5550,0,0,10,0,703,4.3,703,0
5551,1,0,5,7,497,2.86666666666667,469,28
5552,3,0,4,9,574,3.16666666666667,520,54
5553,1,0,2,15,180,0.733333333333333,121,59
5554,1,0,7,8,541,3,492,49
5555,10,12,0,24,462,0,0,462
5556,0,2,0,16,143,0,0,143
5557,0,0,0,10,101,0,0,101
5558,1,0,11,2,766,4.58333333333333,752,14
5559,0,0,9,0,970,5.91666666666667,970,0
5560,6,9,3,14,514,1.5,245,269
5561,8,0,4,0,319,1.95,319,0
5562,0,0,1,11,147,0.216666666666667,36,111
5564,0,0,6,3,348,2,328,20
5567,0,0,9,1,685,4.13333333333333,677,8
5568,0,5,8,5,815,4.83333333333333,793,22
5570,3,3,0,13,273,0,0,273
5571,0,3,0,15,295,0,0,295
5572,2,0,2,12,503,1.43333333333333,235,268
5573,0,0,4,3,310,1.85,303,7
5574,4,1,1,14,420,0.966666666666667,159,261
5575,1,0,10,1,736,4.48333333333333,735,1
5577,0,2,5,0,451,2.75,451,0
5578,6,1,1,13,333,0.366666666666667,60,273
5579,1,0,3,12,617,2.3,377,240
5580,0,0,9,5,535,3.05,500,35
5581,0,0,5,11,839,3.93333333333333,645,194
5582,0,0,8,0,622,3.78333333333333,622,0
5583,0,0,9,0,383,2.33333333333333,383,0
5584,0,0,4,11,779,3.48333333333333,572,207
5585,8,0,7,0,643,3.91666666666667,643,0
5586,0,2,5,1,631,3.56666666666667,585,46
5587,0,0,7,0,569,3.46666666666667,569,0
5588,0,0,7,1,421,2.28333333333333,375,46
5589,0,0,5,6,548,3.05,501,47
5590,0,0,8,2,820,4.96666666666667,814,6
5591,0,0,10,0,660,4.03333333333333,660,0
5592,1,0,3,11,177,0.516666666666667,85,92
5593,3,0,6,12,1229,6.45,1058,171
5594,1,3,2,7,325,1.68333333333333,276,49
5595,2,0,1,11,150,0.216666666666667,36,114
5596,0,0,11,0,681,4.15,681,0
5597,9,0,7,14,654,3.26666666666667,537,117
5598,0,0,1,11,138,0.216666666666667,36,102
5599,4,0,8,8,993,5.6,918,75
5600,2,0,4,8,258,1.41666666666667,231,27
5601,6,0,1,10,134,0.4,66,68
5602,0,0,7,1,313,1.63333333333333,267,46
5603,0,5,0,18,262,0,0,262
5604,0,4,0,20,202,0,0,202
5605,0,0,3,10,145,0.316666666666667,53,92
5606,1,0,0,10,155,0,0,155
5607,0,0,5,3,481,2.9,475,6
5609,3,0,2,16,645,2.13333333333333,350,295
5610,0,0,5,6,424,2.41666666666667,397,27
5611,0,0,7,1,697,4.25,696,1
5612,2,0,3,7,225,1.1,180,45
5613,0,0,2,14,181,0.366666666666667,61,120
5614,1,9,6,6,612,3.5,574,38
5615,0,0,0,11,99,0,0,99
5616,0,0,2,12,429,1.68333333333333,276,153
5617,0,0,14,0,893,5.45,893,0
5618,0,0,3,8,165,0.4,66,99
5619,0,0,12,2,639,3.81666666666667,625,14
5620,0,5,0,12,266,0,0,266
5621,2,0,6,9,886,4.38333333333333,718,168
5622,0,2,0,15,184,0,0,184
5623,8,11,0,23,288,0,0,288
5624,2,0,7,4,547,2.96666666666667,488,59
5625,0,0,13,0,884,5.4,884,0
5627,0,0,6,0,371,2.26666666666667,371,0
5628,0,0,11,3,737,4.43333333333333,728,9
5630,0,0,10,0,933,5.68333333333333,933,0
5631,1,1,0,13,248,0,0,248
5632,0,0,11,0,872,5.31666666666667,872,0
5633,0,0,7,0,560,3.41666666666667,560,0
5634,0,3,0,16,487,0,0,487
5635,3,0,5,12,265,1.21666666666667,200,65
5636,0,0,2,11,156,0.266666666666667,44,112
5637,0,1,6,1,568,3.45,567,1
5638,5,7,0,13,141,0,0,141
5639,0,0,13,0,886,5.4,886,0
5640,5,10,0,20,322,0,0,322
5641,2,0,5,10,625,2.75,451,174
5642,0,0,4,11,913,4.25,696,217
5643,0,0,1,11,202,0.216666666666667,36,166
5644,0,2,9,0,700,4.26666666666667,700,0
5645,1,0,0,9,97,0,0,97
5646,3,5,0,13,311,0,0,311
5647,0,0,9,0,470,2.86666666666667,470,0
5648,5,5,2,12,250,0.433333333333333,71,179
5649,0,0,11,0,689,4.2,689,0
5650,0,0,4,0,410,2.5,410,0
5651,0,0,1,13,130,0.0833333333333333,14,116
5652,0,0,0,9,142,0,0,142
5653,0,0,9,0,563,3.43333333333333,563,0
5655,7,0,3,12,541,2.95,484,57
5656,0,0,11,0,1056,6.43333333333333,1056,0
5657,2,0,5,12,950,4.41666666666667,725,225
5658,0,2,4,1,350,1.63333333333333,268,82
5659,3,0,3,15,393,1.75,287,106
5660,0,0,11,0,651,3.96666666666667,651,0
5661,6,2,6,0,575,3.51666666666667,575,0
5663,0,0,5,0,396,2.41666666666667,396,0
5664,0,0,2,13,223,0.366666666666667,61,162
5665,0,0,13,0,551,3.36666666666667,551,0
5666,0,0,10,3,736,4.41666666666667,723,13
5667,0,0,8,0,877,5.35,877,0
5668,2,3,1,10,387,1.11666666666667,183,204
5669,0,0,9,1,628,3.65,599,29
5670,0,2,6,1,996,5.8,950,46
5671,9,7,1,19,441,1,164,277
5672,3,0,3,13,647,2.98333333333333,489,158
5673,0,0,4,1,251,1.25,205,46
5674,5,7,5,13,883,3.9,640,243
5675,0,0,5,0,329,2,329,0
5676,0,0,4,12,218,0.566666666666667,94,124
5678,1,0,6,7,420,1.76666666666667,289,131
5679,2,0,6,5,681,3.86666666666667,634,47
5680,2,0,1,17,352,0.6,98,254
5681,7,7,1,13,335,0.316666666666667,52,283
5682,5,6,0,13,147,0,0,147
5683,2,0,5,7,465,2.5,410,55
5684,0,0,9,0,369,2.25,369,0
5685,9,0,5,1,464,2.81666666666667,463,1
5686,6,4,0,10,159,0,0,159
5687,8,5,1,13,291,0.316666666666667,52,239
5688,5,0,3,16,622,2.05,336,286
5689,0,0,16,0,826,5.05,826,0
5691,0,0,15,0,751,4.6,751,0
5692,0,0,3,0,350,2.13333333333333,350,0
5693,4,4,0,19,398,0,0,398
5694,0,0,5,4,377,2.25,369,8
5695,0,0,6,0,437,2.66666666666667,437,0
5696,2,0,2,11,248,1.06666666666667,175,73
5697,0,1,0,16,506,0,0,506
5698,0,0,5,0,350,2.13333333333333,350,0
5699,0,0,10,1,690,4.2,689,1
5700,0,0,2,11,150,0.3,50,100
5701,13,13,0,26,236,0,0,236
5702,3,0,5,11,1078,5.28333333333333,866,212
5703,10,4,3,11,413,0.75,123,290
5704,0,0,14,0,972,5.93333333333333,972,0
5705,0,0,6,3,410,2.45,402,8
5706,0,0,6,0,311,1.9,311,0
5707,2,0,11,2,731,4.45,729,2
5708,0,0,6,3,527,3.06666666666667,504,23
5709,0,0,8,0,894,5.45,894,0
5710,0,0,3,10,155,0.45,74,81
5711,0,0,6,4,438,2.6,427,11
5712,2,0,6,11,1165,5.96666666666667,978,187
5713,1,0,3,10,338,1.9,311,27
5714,0,0,4,8,185,0.7,115,70
5715,3,1,0,9,99,0,0,99
5716,0,0,14,0,897,5.46666666666667,897,0
5717,4,7,6,17,1030,5.33333333333333,874,156
5718,0,3,0,20,234,0,0,234
5719,3,3,0,18,292,0,0,292
5720,0,0,13,0,979,5.96666666666667,979,0
5721,1,2,8,6,538,3.06666666666667,504,34
5722,3,0,5,13,786,3.1,509,277
5723,2,5,1,13,475,2.01666666666667,331,144
5724,7,0,6,0,392,2.38333333333333,392,0
5725,0,0,13,1,655,3.98333333333333,654,1
5726,0,3,0,17,199,0,0,199
5727,2,0,3,11,187,0.916666666666667,151,36
5728,0,0,13,2,1199,7.1,1164,35
5729,1,0,11,1,787,4.78333333333333,785,2
5730,3,0,4,7,275,1.31666666666667,216,59
5731,0,0,1,12,131,0.216666666666667,36,95
5732,1,0,5,9,534,2.95,484,50
5733,0,0,12,0,783,4.76666666666667,783,0
5734,5,2,1,8,233,0.433333333333333,71,162
5735,8,12,0,23,425,0,0,425
5736,0,0,16,0,1335,8.15,1335,0
5737,4,1,2,12,498,1.73333333333333,284,214
5738,2,0,1,14,418,0.8,131,287
5739,2,4,1,11,255,0.316666666666667,52,203
5741,1,0,8,3,549,3.33333333333333,546,3
5742,1,0,5,6,460,2.4,393,67
5743,0,1,0,11,315,0,0,315
5745,2,0,9,4,533,3.15,518,15
5746,0,3,0,17,147,0,0,147
5747,0,0,10,1,823,4.96666666666667,815,8
5748,0,0,14,0,838,5.11666666666667,838,0
5749,0,7,2,9,517,1.96666666666667,323,194
5750,0,1,0,14,210,0,0,210
5751,7,1,4,0,395,2.4,395,0
5752,0,0,15,0,567,3.46666666666667,567,0
5753,0,0,11,0,712,4.33333333333333,712,0
5754,8,0,4,0,298,1.81666666666667,298,0
5755,0,0,1,9,98,0.133333333333333,22,76
5756,0,0,2,8,109,0.416666666666667,68,41
5757,0,1,6,0,282,1.71666666666667,282,0
5758,3,5,1,10,236,0.316666666666667,52,184
5759,4,3,1,10,267,0.316666666666667,52,215
5760,0,0,10,0,456,2.78333333333333,456,0
5762,2,3,0,12,259,0,0,259
5763,0,0,6,4,421,2.5,410,11
5764,3,2,0,15,257,0,0,257
5765,0,0,10,0,615,3.75,615,0
5766,0,0,7,0,688,4.2,688,0
5767,2,5,1,15,567,2.01666666666667,331,236
5768,2,0,6,7,421,2.43333333333333,399,22
5769,0,0,5,1,330,1.73333333333333,284,46
5770,0,0,7,9,479,1.9,313,166
5771,0,0,9,1,727,4.41666666666667,724,3
5773,0,0,8,2,592,3.48333333333333,572,20
5774,6,0,6,0,352,2.15,352,0
5775,12,10,0,13,249,0,0,249
5776,3,0,5,8,263,1.26666666666667,208,55
5777,1,0,8,3,551,3.31666666666667,543,8
5779,1,0,9,3,629,3.71666666666667,610,19
5780,0,1,16,0,654,3.98333333333333,654,0
5781,0,0,7,0,440,2.68333333333333,440,0
5782,0,0,11,0,648,3.95,648,0
5783,9,10,0,20,295,0,0,295
5784,0,0,8,0,459,2.8,459,0
5785,0,0,10,0,483,2.95,483,0
5786,1,0,17,0,712,4.35,712,0
5787,1,0,1,13,324,0.366666666666667,60,264
5789,4,5,0,11,146,0,0,146
5790,0,0,6,2,595,3.61666666666667,593,2
5791,0,0,2,11,141,0.3,50,91
5792,2,2,0,4,148,0,0,148
5793,2,0,3,15,628,2.36666666666667,388,240
5794,1,0,3,10,347,1.53333333333333,251,96
5796,0,0,11,0,576,3.51666666666667,576,0
5797,0,3,0,10,112,0,0,112
5798,0,0,3,16,200,0.416666666666667,69,131
5799,0,0,0,15,171,0,0,171
5800,2,0,6,7,514,2.76666666666667,453,61
5801,0,0,10,0,1204,7.33333333333333,1204,0
5802,0,0,8,2,556,3.33333333333333,546,10
5803,0,0,4,0,114,0.7,114,0
5804,0,4,0,16,302,0,0,302
5805,0,0,0,12,328,0,0,328
5806,0,3,0,16,323,0,0,323
5807,4,0,0,14,260,0,0,260
5808,0,0,12,0,802,4.88333333333333,802,0
5809,0,1,7,0,689,4.2,689,0
5810,4,5,1,12,264,0.316666666666667,52,212
5811,5,0,8,0,512,3.11666666666667,512,0
5812,0,0,15,0,1330,8.11666666666667,1330,0
5813,0,0,9,1,780,4.75,779,1
5814,0,1,0,14,259,0,0,259
5815,3,1,0,10,218,0,0,218
5816,6,0,5,17,947,4.6,754,193
5817,0,0,3,12,210,0.45,75,135
5818,7,6,0,12,284,0,0,284
5819,6,5,0,16,349,0,0,349
5820,4,1,1,16,434,0.916666666666667,150,284
5821,0,0,12,0,523,3.2,523,0
5822,0,2,5,3,361,2.08333333333333,340,21
5823,0,0,13,0,589,3.6,589,0
5824,4,3,1,9,218,0.183333333333333,30,188
5825,0,0,6,0,440,2.68333333333333,440,0
5826,0,0,11,0,834,5.08333333333333,834,0
5827,0,0,2,13,191,0.216666666666667,35,156
5828,0,0,5,5,368,1.91666666666667,314,54
5829,5,0,4,13,313,1.31666666666667,216,97
5830,2,0,4,10,768,3.26666666666667,535,233
5831,0,0,11,0,678,4.13333333333333,678,0
5833,0,0,4,0,205,1.25,205,0
5834,2,0,2,11,326,1.56666666666667,257,69
5835,2,0,4,14,597,2.6,427,170
5836,0,0,12,0,738,4.5,738,0
5837,9,0,6,0,416,2.53333333333333,416,0
5838,0,0,13,0,416,2.53333333333333,416,0
5839,6,6,0,17,248,0,0,248
5840,1,0,9,3,404,2.43333333333333,400,4
5841,3,1,0,16,126,0,0,126
5842,3,0,1,11,51,0.0666666666666667,11,40
5844,2,0,3,11,293,1.6,263,30
5845,4,0,0,14,119,0,0,119
5846,1,0,1,13,142,0.683333333333333,112,30
5847,10,3,4,0,375,2.28333333333333,375,0
5848,1,1,16,0,861,5.25,861,0
5849,0,0,8,4,773,4.68333333333333,768,5
5850,7,0,5,0,672,4.1,672,0
5851,6,1,6,0,528,3.21666666666667,528,0
5852,2,0,2,9,155,0.733333333333333,120,35
5853,0,0,9,1,785,4.78333333333333,784,1
5854,4,0,0,12,144,0,0,144
5856,2,0,0,13,148,0,0,148
5857,0,0,13,0,1107,6.75,1107,0
5858,0,0,11,0,698,4.25,698,0
5859,3,0,0,17,263,0,0,263
5860,3,0,0,8,99,0,0,99
5861,1,0,1,14,435,1.01666666666667,167,268
5862,0,0,9,0,731,4.45,731,0
5863,6,13,0,18,195,0,0,195
5864,2,0,3,15,583,2.03333333333333,334,249
5865,0,0,9,0,511,3.11666666666667,511,0
5866,0,0,13,0,420,2.56666666666667,420,0
5867,0,0,11,0,825,5.03333333333333,825,0
5868,0,0,9,1,875,5.33333333333333,874,1
5869,0,0,16,0,1104,6.73333333333333,1104,0
5870,2,0,0,13,114,0,0,114
5871,0,0,13,0,439,2.68333333333333,439,0
5872,0,0,12,0,502,3.06666666666667,502,0
5873,1,0,2,10,189,0.816666666666667,134,55
5874,1,0,10,2,769,4.66666666666667,766,3
5875,1,0,1,10,168,0.683333333333333,112,56
5876,5,6,0,16,299,0,0,299
5877,0,0,15,0,1010,6.16666666666667,1010,0
5878,7,2,4,0,396,2.41666666666667,396,0
5879,0,0,13,0,423,2.58333333333333,423,0
5880,2,0,3,13,576,2.28333333333333,374,202
5881,0,0,11,1,643,3.91666666666667,642,1
5882,6,8,0,18,288,0,0,288
5883,0,0,7,1,729,4.43333333333333,728,1
5884,0,0,12,0,498,3.03333333333333,498,0
5885,0,0,10,1,596,3.61666666666667,592,4
5886,10,0,5,0,554,3.38333333333333,554,0
5887,0,0,13,2,798,4.78333333333333,785,13
5888,0,0,11,0,505,3.08333333333333,505,0
5889,2,0,0,15,175,0,0,175
5890,0,0,10,0,493,3,493,0
5891,4,7,0,17,261,0,0,261
5892,0,1,12,0,395,2.4,395,0
5894,5,8,0,7,36,0,0,36
5895,6,2,0,9,92,0,0,92
5896,3,1,0,16,202,0,0,202
5897,1,0,9,3,769,4.65,763,6
5898,5,11,0,17,183,0,0,183
5899,4,0,8,0,584,3.56666666666667,584,0
5900,0,1,9,1,515,3.13333333333333,514,1
5902,0,0,13,0,380,2.31666666666667,380,0
5903,2,0,0,8,97,0,0,97
5904,1,0,10,2,896,5.45,893,3
5906,0,0,3,10,633,2.51666666666667,413,220
5907,0,0,5,11,971,4.76666666666667,782,189
5908,0,0,11,0,765,4.66666666666667,765,0
5909,0,0,14,0,504,3.06666666666667,504,0
5910,2,0,0,12,98,0,0,98
5911,0,0,9,2,581,3.51666666666667,577,4
5912,2,0,0,10,112,0,0,112
5913,0,0,1,12,194,0.516666666666667,85,109
5914,3,0,3,10,255,1.05,172,83
5915,0,0,13,0,877,5.35,877,0
5916,0,0,12,0,444,2.7,444,0
5917,6,1,4,0,442,2.7,442,0
5918,2,0,1,13,270,0.616666666666667,101,169
5919,1,0,1,14,104,0.133333333333333,22,82
5920,0,0,2,10,179,0.483333333333333,79,100
5921,0,0,0,10,97,0,0,97
5922,0,0,10,0,588,3.58333333333333,588,0
5925,5,1,8,2,452,2.75,450,2
5926,3,0,1,10,180,0.683333333333333,112,68
5927,0,0,7,1,499,3.03333333333333,498,1
5931,0,0,13,0,1082,6.6,1082,0
5932,0,0,11,0,1138,6.95,1138,0
5933,5,8,0,17,245,0,0,245
5934,5,5,0,11,233,0,0,233
5936,6,1,4,18,755,3.1,509,246
5937,0,0,7,0,397,2.41666666666667,397,0
5938,0,0,9,0,519,3.16666666666667,519,0
5939,0,0,7,2,416,2.48333333333333,407,9
5940,0,0,6,2,568,3.45,566,2
5941,1,4,1,11,224,0.316666666666667,52,172
5942,3,2,2,11,548,2.8,459,89
5943,0,0,13,0,881,5.36666666666667,881,0
5944,2,6,2,14,357,0.65,107,250
5945,0,0,5,0,400,2.43333333333333,400,0
5947,3,8,6,7,1144,6.6,1082,62
5948,1,0,2,14,384,1.38333333333333,227,157
5949,7,11,0,16,171,0,0,171
5950,0,0,1,12,131,0.216666666666667,36,95
5951,0,0,8,0,675,4.11666666666667,675,0
5952,0,0,7,0,448,2.73333333333333,448,0
5953,1,0,0,6,44,0,0,44
5954,1,0,1,11,187,0.683333333333333,112,75
5957,0,0,12,0,506,3.08333333333333,506,0
5958,0,0,9,0,685,4.18333333333333,685,0
5959,0,0,7,0,616,3.75,616,0
5960,0,0,8,0,509,3.1,509,0
5961,0,0,1,10,84,0.133333333333333,22,62
5962,0,0,4,0,615,3.75,615,0
5963,2,0,1,8,202,0.683333333333333,112,90
5964,8,9,0,13,164,0,0,164
5965,0,0,1,14,184,0.216666666666667,36,148
5966,1,6,0,13,156,0,0,156
5967,6,9,0,19,215,0,0,215
5968,0,0,9,0,613,3.73333333333333,613,0
5969,0,5,0,12,167,0,0,167
5970,0,0,6,1,503,3.06666666666667,502,1
5971,1,1,5,6,439,2.43333333333333,399,40
5972,0,0,4,0,218,1.33333333333333,218,0
5973,0,0,12,0,733,4.46666666666667,733,0
5974,0,0,10,0,517,3.15,517,0
5975,1,0,3,10,179,0.416666666666667,69,110
5976,0,0,5,12,799,3.61666666666667,593,206
5977,1,0,3,15,220,0.45,75,145
5978,0,0,0,14,152,0,0,152
5979,0,0,2,11,322,1.41666666666667,232,90
5980,1,1,2,12,450,1.4,229,221
5981,0,0,6,0,283,1.71666666666667,283,0
5982,1,0,3,7,259,1.1,180,79
5983,0,0,10,0,760,4.63333333333333,760,0
5984,1,0,2,11,350,1.7,279,71
5985,3,0,0,14,184,0,0,184
5986,4,2,4,18,645,2.23333333333333,367,278
5987,2,0,3,10,247,1.21666666666667,200,47
5988,0,0,5,0,487,2.96666666666667,487,0
5989,0,0,3,0,404,2.46666666666667,404,0
5990,0,0,5,0,228,1.38333333333333,228,0
5991,0,1,0,9,129,0,0,129
5992,0,0,16,0,874,5.33333333333333,874,0
5993,0,0,10,0,814,4.96666666666667,814,0
5994,0,0,10,0,604,3.68333333333333,604,0
5995,0,0,9,0,418,2.55,418,0
5996,0,1,4,0,407,2.48333333333333,407,0
5997,0,1,6,13,1276,7.48333333333333,1228,48
5998,2,0,2,11,199,0.816666666666667,134,65
5999,4,1,4,19,832,3.6,591,241
6000,0,0,6,0,328,2,328,0
6001,0,0,4,0,304,1.85,304,0
6002,0,0,4,9,923,4.33333333333333,710,213
6003,0,3,0,18,165,0,0,165
6004,0,0,6,0,260,1.58333333333333,260,0
6005,0,2,5,0,622,3.78333333333333,622,0
6006,5,6,0,12,114,0,0,114
6007,0,0,8,0,641,3.9,641,0
6008,0,0,5,12,689,3.01666666666667,496,193
6009,2,0,3,15,508,1.58333333333333,260,248
6010,0,0,7,0,529,3.23333333333333,529,0
6011,4,0,2,3,442,2.5,410,32
6012,1,0,1,12,130,0.133333333333333,22,108
6013,1,0,4,2,203,1.21666666666667,200,3
6014,6,12,0,16,235,0,0,235
6015,0,0,10,0,662,4.03333333333333,662,0
6016,1,0,1,10,201,0.683333333333333,112,89
6017,3,0,2,12,214,0.816666666666667,134,80
6018,0,0,9,0,631,3.85,631,0
6019,3,0,4,13,809,4,656,153
6020,0,5,1,11,243,0.316666666666667,52,191
6021,0,0,7,0,545,3.31666666666667,545,0
6022,9,9,0,21,271,0,0,271
6023,0,0,8,2,489,2.95,484,5
6024,1,2,6,3,1263,7.6,1246,17
6025,0,0,10,0,624,3.8,624,0
6026,0,0,12,0,578,3.53333333333333,578,0
6027,0,0,10,0,697,4.25,697,0
6028,0,0,10,0,765,4.66666666666667,765,0
6029,0,0,10,0,695,4.23333333333333,695,0
6030,1,0,2,7,323,1.7,279,44
6031,3,0,0,11,102,0,0,102
6033,1,3,4,8,732,4.25,697,35
6034,0,0,8,1,530,3.21666666666667,528,2
6035,1,0,4,1,1302,7.93333333333333,1301,1
6036,5,8,2,17,482,2.33333333333333,382,100
6037,3,0,0,13,148,0,0,148
6038,0,0,10,0,798,4.86666666666667,798,0
6039,0,0,9,0,556,3.38333333333333,556,0
6040,0,0,8,0,506,3.1,506,0
6041,0,3,7,2,1184,7.2,1182,2
6042,4,1,0,11,113,0,0,113
6043,0,0,1,12,239,0.916666666666667,150,89
6044,0,0,12,0,539,3.28333333333333,539,0
6045,0,0,9,0,680,4.15,680,0
6046,0,0,4,0,745,4.55,745,0
6047,1,0,2,12,407,1.41666666666667,232,175
6048,1,0,5,12,826,3.65,600,226
6049,0,0,0,13,129,0,0,129
6050,0,0,14,0,455,2.78333333333333,455,0
6051,0,0,7,1,353,2.15,351,2
6052,0,0,8,0,583,3.55,583,0
6053,2,0,4,14,841,3.46666666666667,569,272
6054,0,0,7,0,565,3.45,565,0
6055,0,0,6,2,493,2.96666666666667,487,6
6056,1,0,3,13,714,3.06666666666667,504,210
6057,3,0,0,16,87,0,0,87
6058,0,0,0,10,84,0,0,84
6059,2,0,0,15,158,0,0,158
6060,0,0,0,12,102,0,0,102
6061,2,1,0,12,157,0,0,157
6062,2,0,4,10,746,3.4,557,189
6063,1,0,0,15,170,0,0,170
6064,0,0,2,9,154,0.3,50,104
6065,0,0,2,13,159,0.3,50,109
6066,3,0,4,11,767,4.18333333333333,686,81
6067,2,0,0,19,153,0,0,153
6068,0,0,4,0,164,1,164,0
6069,0,0,1,10,121,0.216666666666667,36,85
6070,0,0,10,0,319,1.95,319,0
6071,0,0,4,0,309,1.88333333333333,309,0
6072,0,0,6,0,757,4.61666666666667,757,0
6073,7,6,0,21,312,0,0,312
6074,0,0,1,14,106,0.133333333333333,22,84
6075,0,0,6,0,439,2.66666666666667,439,0
6076,2,0,0,13,140,0,0,140
6077,0,0,3,0,293,1.78333333333333,293,0
6078,0,0,7,0,926,5.63333333333333,926,0
6079,1,0,2,18,366,0.983333333333333,162,204
6080,0,0,1,16,194,0.216666666666667,36,158
6082,1,1,0,19,248,0,0,248
6083,0,0,9,0,640,3.9,640,0
6084,0,1,0,13,144,0,0,144
6085,1,0,2,12,545,1.93333333333333,317,228
6087,9,10,0,20,301,0,0,301
6088,4,1,1,14,114,0.133333333333333,22,92
6089,5,6,0,15,219,0,0,219
6090,0,0,1,14,155,0.216666666666667,36,119
6091,1,0,1,13,113,0.133333333333333,22,91
6092,1,1,2,11,252,0.766666666666667,126,126
6094,13,11,0,21,278,0,0,278
6095,1,0,2,12,383,1.7,279,104
6096,0,0,11,0,670,4.08333333333333,670,0
6097,2,8,2,12,305,0.65,107,198
6098,0,0,9,0,582,3.55,582,0
6100,0,0,7,0,618,3.76666666666667,618,0
6102,0,0,9,0,709,4.31666666666667,709,0
6104,0,0,6,1,552,3.08333333333333,506,46
6105,0,0,10,2,512,3.1,508,4
6107,0,1,0,14,203,0,0,203
6108,0,0,10,0,739,4.5,739,0
6109,0,0,9,0,661,4.03333333333333,661,0
6110,0,0,14,0,704,4.3,704,0
6111,1,1,2,12,449,1.3,214,235
6112,0,0,10,0,538,3.28333333333333,538,0
6113,0,0,12,0,684,4.16666666666667,684,0
6114,0,0,4,10,594,2.23333333333333,366,228
6115,0,0,2,10,139,0.25,41,98
6116,0,0,11,0,799,4.86666666666667,799,0
6117,2,7,0,25,322,0,0,322
6118,0,0,8,0,612,3.73333333333333,612,0
6119,0,1,5,0,468,2.85,468,0
6120,1,1,4,15,738,3.16666666666667,520,218
6121,2,1,0,13,136,0,0,136
6122,1,3,0,16,153,0,0,153
6123,0,0,2,10,129,0.3,50,79
6124,0,0,1,12,164,0.483333333333333,79,85
6125,2,0,3,13,663,2.46666666666667,405,258
6126,0,0,7,1,436,2.65,434,2
6127,5,0,1,11,139,0.133333333333333,22,117
6128,0,0,11,0,725,4.41666666666667,725,0
6129,6,0,4,16,785,3.78333333333333,621,164
6130,5,4,1,16,274,1.05,172,102
6131,0,0,4,1,472,2.6,426,46
6132,1,0,1,9,182,0.75,123,59
6133,1,0,4,14,779,3.53333333333333,579,200
6134,0,0,10,0,554,3.38333333333333,554,0
6135,2,0,0,15,131,0,0,131
6136,1,0,3,8,232,1.11666666666667,183,49
6137,0,0,7,1,498,3.03333333333333,497,1
6138,0,0,10,0,646,3.93333333333333,646,0
6139,0,5,2,14,313,0.65,107,206
6140,0,0,10,0,694,4.23333333333333,694,0
6141,0,4,1,11,222,0.316666666666667,52,170
6142,0,0,9,0,671,4.1,671,0
6143,0,0,3,10,297,1.3,213,84
6145,0,0,8,1,629,3.83333333333333,628,1
6146,0,0,2,13,190,0.3,50,140
6147,0,0,2,10,176,0.566666666666667,93,83
6148,0,0,9,0,579,3.53333333333333,579,0
6149,1,1,4,11,911,4.23333333333333,694,217
6150,0,0,11,0,773,4.71666666666667,773,0
6152,0,0,10,1,599,3.65,598,1
6153,0,0,8,0,516,3.15,516,0
6154,4,3,4,15,1030,4.88333333333333,801,229
6155,0,0,1,12,119,0.133333333333333,22,97
6156,0,0,2,9,219,1.05,172,47
6157,0,0,10,0,827,5.05,827,0
6158,5,0,1,16,161,0.133333333333333,22,139
6159,0,1,8,1,762,4.36666666666667,716,46
6160,4,0,2,19,592,1.76666666666667,290,302
6161,6,0,1,20,140,0.15,25,115
6162,0,0,9,0,507,3.08333333333333,507,0
6164,0,0,8,0,874,5.33333333333333,874,0
6166,0,0,0,10,97,0,0,97
6167,0,0,11,0,454,2.76666666666667,454,0
6168,0,0,1,11,129,0.216666666666667,36,93
6169,0,0,6,0,420,2.55,420,0
6170,2,0,3,10,488,1.71666666666667,282,206
6171,0,0,7,1,337,2.05,336,1
6172,1,2,0,10,145,0,0,145
6173,2,0,9,2,1110,6.63333333333333,1089,21
6175,1,0,2,9,340,1.7,279,61
6176,0,0,12,0,832,5.06666666666667,832,0
6177,0,0,7,1,643,3.91666666666667,642,1
6178,0,0,12,1,836,5.05,829,7
6179,0,0,11,0,1344,8.2,1344,0
6180,0,0,5,0,997,6.08333333333333,997,0
6181,0,0,2,10,140,0.3,50,90
6182,0,1,5,0,768,4.68333333333333,768,0
6184,0,0,6,5,343,2.01666666666667,331,12
6185,0,1,3,0,254,1.55,254,0
6186,0,0,5,0,596,3.63333333333333,596,0
6188,0,1,7,5,459,2.65,434,25
6189,1,0,1,10,233,0.95,156,77
6191,0,0,6,1,619,3.76666666666667,618,1
6192,3,0,3,17,628,2.55,419,209
6194,0,0,12,0,790,4.81666666666667,790,0
6195,0,0,9,0,494,3.01666666666667,494,0
6196,6,1,3,18,757,2.65,435,322
6197,0,0,10,0,776,4.73333333333333,776,0
6198,3,7,0,13,153,0,0,153
6199,2,0,1,16,217,0.683333333333333,112,105
6200,2,0,2,14,173,0.483333333333333,79,94
6201,0,0,6,0,426,2.6,426,0
6202,0,0,1,11,129,0.216666666666667,36,93
6203,0,0,7,0,907,5.53333333333333,907,0
6204,5,0,1,21,165,0.15,25,140
6205,0,0,1,10,145,0.216666666666667,36,109
6206,6,0,0,16,92,0,0,92
6207,0,0,1,10,268,0.95,156,112
6209,0,0,5,0,274,1.66666666666667,274,0
6210,2,2,2,2,147,0.866666666666667,142,5
6211,3,0,4,13,1035,4.61666666666667,757,278
6212,0,0,10,0,556,3.38333333333333,556,0
6213,2,1,2,14,536,2,328,208
6215,0,0,17,0,994,6.05,994,0
6216,7,5,5,13,607,2.43333333333333,399,208
6217,0,0,2,9,384,1.7,279,105
6218,0,2,4,0,248,1.51666666666667,248,0
6219,0,0,11,0,921,5.61666666666667,921,0
6220,0,0,1,10,103,0.133333333333333,22,81
6222,0,0,8,0,498,3.03333333333333,498,0
6223,0,0,1,9,149,0.316666666666667,52,97
6224,0,0,5,1,896,5.18333333333333,850,46
6225,0,6,2,10,235,0.933333333333333,153,82
6226,0,0,5,0,609,3.71666666666667,609,0
6227,2,0,3,14,570,2.31666666666667,381,189
6228,6,0,0,17,97,0,0,97
6229,0,0,8,1,553,3.36666666666667,552,1
6230,0,1,6,0,442,2.68333333333333,442,0
6231,3,1,0,3,17,0,0,17
6232,1,0,8,3,1499,9.06666666666667,1488,11
6233,0,0,8,1,709,4.31666666666667,708,1
6234,0,0,4,0,325,1.98333333333333,325,0
6235,0,0,12,0,699,4.26666666666667,699,0
6236,0,0,6,1,821,4.73333333333333,775,46
6237,0,0,11,0,656,4,656,0
6238,0,0,12,0,974,5.93333333333333,974,0
6239,5,0,5,18,1106,4.95,813,293
6240,1,0,10,0,1863,11.35,1863,0
6241,4,0,3,12,542,1.95,321,221
6242,4,1,2,11,235,0.983333333333333,161,74
6243,2,1,0,9,192,0,0,192
6244,4,4,6,7,932,5.2,853,79
6245,3,0,4,12,938,4.45,730,208
6246,3,8,0,13,226,0,0,226
6247,0,0,1,8,88,0.133333333333333,22,66
6248,13,0,1,15,66,0.1,16,50
6249,0,0,1,13,146,0.133333333333333,22,124
6250,0,0,5,0,896,5.46666666666667,896,0
6251,0,0,0,7,79,0,0,79
6252,0,0,9,1,620,3.78333333333333,619,1
6253,0,0,10,0,557,3.4,557,0
6254,8,7,0,18,304,0,0,304
6255,0,0,2,11,381,1.7,279,102
6256,0,1,7,5,377,2.25,370,7
6257,3,1,2,15,233,0.816666666666667,134,99
6258,0,0,3,1,275,1.4,229,46
6259,0,1,4,0,568,3.46666666666667,568,0
6260,0,0,10,0,629,3.83333333333333,629,0
6261,6,3,0,14,248,0,0,248
6263,4,9,0,18,268,0,0,268
6265,0,0,1,9,296,0.95,156,140
6266,0,0,1,11,127,0.216666666666667,36,91
6267,5,0,0,22,139,0,0,139
6268,3,1,3,17,618,2.06666666666667,339,279
6269,0,0,11,0,744,4.53333333333333,744,0
6270,4,4,4,8,231,0.933333333333333,154,77
6272,5,1,3,17,563,1.71666666666667,282,281
6273,0,0,8,0,584,3.55,584,0
6274,0,0,1,11,122,0.133333333333333,22,100
6275,2,1,2,4,487,2.9,475,12
6277,0,1,5,0,546,3.33333333333333,546,0
6278,0,0,2,10,388,1.7,279,109
6279,2,0,1,18,100,0.15,25,75
6280,3,0,2,14,212,0.816666666666667,134,78
6281,0,0,2,12,153,0.3,50,103
6282,4,7,0,13,185,0,0,185
6283,3,3,0,13,143,0,0,143
6284,0,1,3,5,217,1.2,197,20
6285,5,1,3,26,873,2.51666666666667,413,460
6286,0,0,8,1,543,3.3,542,1
6287,0,0,2,13,474,1.36666666666667,225,249
6288,0,2,10,3,614,3.73333333333333,611,3
6289,0,0,2,14,557,1.75,287,270
6292,0,0,9,0,510,3.1,510,0
6293,0,0,1,8,100,0.0833333333333333,14,86
6294,5,0,4,16,749,3.06666666666667,503,246
6295,0,3,7,5,547,3.3,542,5
6296,0,0,1,10,254,0.75,123,131
6297,1,2,0,5,26,0,0,26
6298,1,0,1,12,261,0.95,156,105
6299,4,1,3,16,570,1.85,304,266
6300,1,0,1,10,87,0.0833333333333333,14,73
6301,0,0,1,7,82,0.15,25,57
6302,1,0,2,10,373,1.7,279,94
6303,0,1,3,0,213,1.3,213,0
6304,0,0,2,7,119,0.3,50,69
6305,0,0,16,0,1312,8,1312,0
6306,7,6,0,8,90,0,0,90
6307,0,0,10,0,609,3.71666666666667,609,0
6308,4,0,1,13,195,0.683333333333333,112,83
6309,0,0,12,0,1077,6.56666666666667,1077,0
6310,0,0,14,0,914,5.56666666666667,914,0
6311,0,0,10,0,703,4.28333333333333,703,0
6312,13,0,1,19,131,0.15,25,106
6313,1,0,1,14,141,0.0833333333333333,14,127
6314,0,2,0,9,106,0,0,106
6315,0,0,4,0,309,1.88333333333333,309,0
6316,10,11,0,20,265,0,0,265
6317,0,0,9,0,489,2.98333333333333,489,0
6318,4,0,0,19,164,0,0,164
6319,0,0,9,0,503,3.06666666666667,503,0
6321,1,0,2,13,161,0.3,50,111
6322,5,5,0,8,52,0,0,52
6323,6,8,0,17,213,0,0,213
6325,1,0,2,8,122,0.3,50,72
6326,1,0,2,11,128,0.3,50,78
6327,1,0,1,12,115,0.133333333333333,22,93
6328,0,0,3,1,272,1.38333333333333,226,46
6329,0,0,9,0,560,3.41666666666667,560,0
6330,0,0,2,8,129,0.366666666666667,61,68
6331,0,0,4,0,700,4.26666666666667,700,0
6332,0,0,2,9,392,1.7,279,113
6333,4,0,4,17,841,3.51666666666667,577,264
6334,0,6,2,14,375,0.65,107,268
6335,2,11,2,15,431,0.65,107,324
6336,0,9,1,15,293,0.316666666666667,52,241
6337,1,7,1,15,329,0.333333333333333,55,274
6338,3,3,0,19,270,0,0,270
6339,2,10,0,14,228,0,0,228
6340,5,7,0,13,128,0,0,128
6342,2,0,7,4,800,4.71666666666667,773,27
6343,1,0,0,9,131,0,0,131
6344,6,2,0,15,171,0,0,171
6345,1,0,8,1,458,2.78333333333333,457,1
6347,1,1,0,6,60,0,0,60
6348,4,4,0,13,157,0,0,157
6349,0,0,5,0,500,3.05,500,0
6350,0,0,0,12,75,0,0,75
6353,1,0,12,0,536,3.26666666666667,536,0
6354,1,0,9,1,504,3.06666666666667,503,1
6355,1,0,2,11,229,0.816666666666667,134,95
6356,1,0,2,13,452,1.28333333333333,211,241
6358,1,1,3,14,472,1.55,255,217
6359,0,0,4,0,191,1.16666666666667,191,0
6360,10,0,6,0,585,3.56666666666667,585,0
6361,5,0,0,8,72,0,0,72
6362,0,0,4,0,213,1.3,213,0
6363,9,0,4,0,271,1.65,271,0
6364,1,0,0,15,36,0,0,36
6365,2,0,5,14,900,4.11666666666667,677,223
6366,5,0,3,14,535,1.9,311,224
6367,10,0,7,0,783,4.76666666666667,783,0
6368,0,0,4,1,568,3.18333333333333,522,46
6369,1,0,11,0,584,3.56666666666667,584,0
6370,0,0,2,14,203,0.783333333333333,129,74
6371,1,0,2,9,137,0.533333333333333,87,50
6372,9,0,7,0,544,3.31666666666667,544,0
6373,6,0,0,16,83,0,0,83
6375,3,0,1,17,263,0.333333333333333,55,208
6376,0,0,17,0,351,2.13333333333333,351,0
6377,7,0,13,25,404,1.98333333333333,327,77
6378,0,0,12,0,342,2.08333333333333,342,0
6380,4,0,0,11,41,0,0,41
6381,4,0,2,17,355,0.983333333333333,162,193
6382,1,0,4,14,695,2.76666666666667,455,240
6383,1,0,3,8,240,1.15,189,51
6385,4,3,0,22,307,0,0,307
6386,8,1,5,0,330,2.01666666666667,330,0
6387,3,1,0,13,155,0,0,155
6388,0,0,5,0,462,2.81666666666667,462,0
6389,0,0,13,0,251,1.53333333333333,251,0
6390,0,0,13,0,343,2.1,343,0
6391,4,0,2,30,234,0.466666666666667,77,157
6392,11,0,4,0,319,1.95,319,0
6393,0,0,0,11,160,0,0,160
6395,1,2,0,14,203,0,0,203
6396,8,1,0,17,165,0,0,165
6397,1,1,4,11,260,1.15,188,72
6398,0,1,4,0,689,4.2,689,0
6399,0,0,4,1,275,1.4,229,46
6401,8,0,4,0,311,1.9,311,0
6402,1,0,2,15,221,0.6,99,122
6403,1,0,8,2,476,2.88333333333333,473,3
6404,0,0,4,1,434,2.36666666666667,388,46
6405,0,3,0,15,209,0,0,209
6406,0,0,0,16,36,0,0,36
6407,0,0,3,0,372,2.26666666666667,372,0
6408,3,4,0,17,148,0,0,148
6409,2,0,8,2,407,2.46666666666667,405,2
6410,0,0,5,0,216,1.31666666666667,216,0
6411,11,0,8,0,745,4.53333333333333,745,0
6412,0,0,0,11,26,0,0,26
6413,1,2,2,15,591,1.98333333333333,326,265
6414,1,0,1,13,122,0.133333333333333,22,100
6415,1,0,2,13,459,1.48333333333333,244,215
6416,0,0,14,0,368,2.25,368,0
6417,2,2,1,17,387,0.766666666666667,126,261
6418,2,0,3,9,227,0.916666666666667,150,77
6419,0,0,11,0,448,2.73333333333333,448,0
6420,8,0,7,0,816,4.96666666666667,816,0
6421,0,0,4,0,292,1.78333333333333,292,0
6422,7,0,5,1,427,2.6,426,1
6423,5,9,0,20,234,0,0,234
6425,6,1,0,12,128,0,0,128
6426,2,0,0,10,129,0,0,129
6427,0,0,0,13,84,0,0,84
6428,0,0,11,0,482,2.93333333333333,482,0
6429,0,0,2,11,148,0.483333333333333,79,69
6430,0,0,1,10,92,0.133333333333333,22,70
6431,2,0,2,10,238,0.966666666666667,158,80
6432,7,0,4,16,1004,4.01666666666667,659,345
6433,11,0,0,22,170,0,0,170
6434,4,9,0,10,166,0,0,166
6435,10,1,4,1,263,1.6,262,1
6436,6,2,0,12,148,0,0,148
6438,0,0,5,0,619,3.76666666666667,619,0
6440,0,0,12,0,850,5.18333333333333,850,0
6442,0,1,4,6,535,2.86666666666667,470,65
6443,2,5,0,19,321,0,0,321
6444,6,1,2,16,267,0.816666666666667,134,133
6445,1,0,2,10,410,1.7,279,131
6446,1,0,2,9,213,0.9,147,66
6447,0,0,9,1,623,3.8,622,1
6448,7,0,0,21,293,0,0,293
6449,0,0,4,9,398,1.96666666666667,322,76
6450,0,0,12,0,372,2.26666666666667,372,0
6451,7,0,0,11,101,0,0,101
6452,6,0,0,26,289,0,0,289
6453,0,0,2,5,168,0.6,98,70
6454,1,0,0,14,136,0,0,136
6455,2,2,0,11,199,0,0,199
6456,0,0,3,0,383,2.33333333333333,383,0
6457,1,2,0,11,86,0,0,86
6458,6,0,0,13,120,0,0,120
6459,7,0,0,23,168,0,0,168
6460,0,0,3,9,303,1.13333333333333,186,117
6461,0,0,2,4,169,0.7,115,54
6462,5,3,0,18,178,0,0,178
6463,0,0,10,0,635,3.86666666666667,635,0
6464,7,5,0,20,236,0,0,236
6465,4,0,0,20,215,0,0,215
6466,11,0,8,0,235,1.43333333333333,235,0
6468,0,0,3,5,206,0.783333333333333,128,78
6469,0,0,9,0,598,3.65,598,0
6470,0,0,4,0,345,2.1,345,0
6471,0,3,0,13,169,0,0,169
6472,9,0,0,27,220,0,0,220
6474,3,1,2,19,448,1.58333333333333,260,188
6476,11,1,6,0,368,2.25,368,0
6478,4,0,0,20,182,0,0,182
6479,6,2,1,24,524,1.11666666666667,183,341
6480,1,0,1,11,202,0.483333333333333,79,123
6482,6,0,0,9,60,0,0,60
6483,0,0,8,3,294,1.73333333333333,285,9
6484,0,0,6,3,341,1.76666666666667,289,52
6485,0,0,6,0,360,2.2,360,0
6486,0,0,3,0,238,1.45,238,0
6487,1,0,10,1,443,2.7,442,1
6488,0,0,5,0,459,2.8,459,0
6489,0,4,0,13,202,0,0,202
6490,3,0,0,13,134,0,0,134
6491,1,2,0,14,159,0,0,159
6492,1,1,0,17,149,0,0,149
6493,0,1,4,0,167,1.01666666666667,167,0
6494,1,1,8,2,373,2.21666666666667,363,10
6496,0,2,0,10,130,0,0,130
6497,4,1,0,14,150,0,0,150
6498,0,0,10,1,246,1.5,245,1
6499,2,3,0,12,159,0,0,159
6500,0,2,0,8,148,0,0,148
6501,0,0,1,13,174,0.5,82,92
6502,0,0,7,1,441,2.68333333333333,440,1
6503,5,1,2,19,499,1.73333333333333,285,214
6504,7,0,0,32,265,0,0,265
6505,7,5,0,30,372,0,0,372
6506,0,0,8,0,320,1.95,320,0
6507,2,0,1,9,212,0.733333333333333,120,92
6508,8,0,0,10,111,0,0,111
6509,12,0,0,35,319,0,0,319
6510,0,2,0,10,126,0,0,126
6511,2,0,0,24,226,0,0,226
6512,4,1,0,23,350,0,0,350
6513,1,0,2,7,310,1.41666666666667,232,78
6514,0,0,2,8,200,0.6,98,102
6515,0,0,11,0,519,3.16666666666667,519,0
6516,1,0,2,18,562,1.75,287,275
6517,0,0,6,0,300,1.83333333333333,300,0
6518,2,5,0,21,193,0,0,193
6519,0,0,13,0,717,4.36666666666667,717,0
6520,14,0,3,0,476,2.9,476,0
6521,1,5,0,10,161,0,0,161
6522,7,1,1,26,493,1.05,172,321
6523,4,5,0,24,291,0,0,291
6524,1,4,0,12,264,0,0,264
6525,10,1,9,0,372,2.26666666666667,372,0
6527,4,0,0,13,60,0,0,60
6528,3,2,1,20,640,1.83333333333333,301,339
6529,0,0,7,0,585,3.56666666666667,585,0
6530,0,0,6,0,289,1.76666666666667,289,0
6531,0,0,12,0,498,3.03333333333333,498,0
6532,0,0,4,0,809,4.93333333333333,809,0
6533,10,0,0,37,289,0,0,289
6534,4,3,0,20,279,0,0,279
6535,1,0,8,2,249,1.5,247,2
6536,2,2,0,15,199,0,0,199
6537,1,0,1,10,172,0.733333333333333,120,52
6538,3,0,0,21,186,0,0,186
6539,2,0,5,2,170,1.01666666666667,167,3
6540,0,0,12,0,564,3.45,564,0
6541,0,0,1,13,200,0.5,82,118
6542,5,0,1,23,527,1.65,271,256
6544,1,7,0,11,156,0,0,156
6545,5,1,2,22,534,1.73333333333333,284,250
6546,0,0,4,4,260,1.2,197,63
6547,3,2,0,11,120,0,0,120
6548,5,4,0,17,147,0,0,147
6549,2,3,0,14,204,0,0,204
6550,0,0,4,0,498,3.03333333333333,498,0
6551,0,0,7,2,167,1,163,4
6552,0,4,0,12,231,0,0,231
6553,0,0,4,4,235,1.08333333333333,177,58
6554,0,0,8,0,430,2.61666666666667,430,0
6555,0,0,1,13,194,0.5,82,112
6556,0,0,13,0,546,3.33333333333333,546,0
6557,9,8,0,22,307,0,0,307
6559,0,0,6,0,380,2.31666666666667,380,0
6560,0,0,1,14,170,0.733333333333333,120,50
6561,1,0,1,9,179,0.733333333333333,120,59
6562,4,2,1,24,371,0.683333333333333,112,259
6563,2,0,0,17,320,0,0,320
6564,2,2,0,8,168,0,0,168
6565,0,0,4,0,394,2.4,394,0
6566,2,0,1,11,162,0.733333333333333,120,42
6567,3,1,0,18,214,0,0,214
6568,4,4,0,20,258,0,0,258
6569,0,0,4,3,153,0.916666666666667,150,3
6570,0,1,0,9,127,0,0,127
6571,0,0,2,0,358,2.18333333333333,358,0
6572,1,0,2,10,208,0.983333333333333,161,47
6573,0,0,8,1,346,2.1,344,2
6574,6,1,0,14,190,0,0,190
6575,12,3,8,0,314,1.91666666666667,314,0
6576,0,3,0,12,159,0,0,159
6577,0,0,3,5,192,0.716666666666667,117,75
6578,1,0,0,16,169,0,0,169
6579,11,0,0,30,256,0,0,256
6580,5,0,0,16,140,0,0,140
6581,6,0,0,20,127,0,0,127
6582,0,0,0,7,100,0,0,100
6583,0,1,0,11,109,0,0,109
6584,0,0,7,1,537,3.26666666666667,536,1
6585,2,5,0,12,173,0,0,173
6586,8,1,0,20,178,0,0,178
6587,5,0,11,0,434,2.65,434,0
6588,0,0,2,7,166,0.5,82,84
6589,0,4,0,14,176,0,0,176
6590,5,1,0,21,308,0,0,308
6591,0,0,7,5,520,2.58333333333333,423,97
6592,7,0,0,27,284,0,0,284
6593,4,0,0,20,284,0,0,284
6594,0,0,6,0,408,2.48333333333333,408,0
6595,0,0,3,5,143,0.733333333333333,120,23
6596,1,5,0,15,104,0,0,104
6597,1,4,0,13,215,0,0,215
6598,6,1,0,22,220,0,0,220
6599,3,0,2,13,387,1.76666666666667,289,98
6600,0,3,0,13,113,0,0,113
6601,0,0,9,4,371,2.08333333333333,342,29
6602,0,0,0,4,53,0,0,53
6603,0,0,7,0,368,2.25,368,0
6604,0,3,0,13,228,0,0,228
6605,0,1,0,11,116,0,0,116
6606,0,2,0,13,144,0,0,144
6607,4,0,1,7,136,0.733333333333333,120,16
6608,10,0,5,0,245,1.5,245,0
6609,0,0,10,1,628,3.81666666666667,627,1
6610,0,0,3,4,164,0.7,115,49
6611,9,5,0,17,295,0,0,295
6612,0,0,8,0,295,1.8,295,0
6613,0,0,5,4,281,1.21666666666667,199,82
6614,0,0,6,0,344,2.1,344,0
6615,0,0,8,0,329,2,329,0
6616,9,0,11,0,433,2.63333333333333,433,0
6618,0,0,12,2,406,2.43333333333333,397,9
6619,1,0,0,17,187,0,0,187
6620,1,0,2,10,251,1.1,180,71
6621,10,1,7,0,371,2.26666666666667,371,0
6622,5,3,0,15,257,0,0,257
6623,5,0,0,17,290,0,0,290
6624,0,0,0,8,129,0,0,129
6625,4,1,0,22,229,0,0,229
6626,1,0,7,1,324,1.96666666666667,322,2
6627,8,0,0,33,258,0,0,258
6628,3,1,0,14,232,0,0,232
6629,0,0,2,5,184,0.7,115,69
6631,0,0,6,1,292,1.78333333333333,291,1
6632,0,0,10,3,616,3.65,599,17
6633,1,0,0,9,32,0,0,32
6634,8,0,0,30,188,0,0,188
6635,9,5,0,19,251,0,0,251
6637,6,2,0,21,234,0,0,234
6638,0,0,7,3,346,2.06666666666667,340,6
6639,0,0,10,2,803,4.88333333333333,801,2
6640,1,0,1,11,222,0.733333333333333,120,102
6641,2,0,2,6,273,1.53333333333333,251,22
6642,5,2,0,20,208,0,0,208
7657,1,0,0,15,287,0,0,287
7658,2,0,3,13,697,3.48333333333333,572,125
7663,0,2,5,9,1381,8.01666666666667,1316,65
7664,0,0,12,0,577,3.51666666666667,577,0
7665,0,0,5,0,502,3.06666666666667,502,0
7666,0,0,15,0,489,2.98333333333333,489,0
7667,0,0,10,0,865,5.26666666666667,865,0
7670,1,0,3,12,538,2.45,402,136
7672,4,1,4,17,499,2.3,377,122
7673,0,1,12,0,907,5.53333333333333,907,0
7674,6,0,0,14,100,0,0,100
7675,6,0,5,0,181,1.1,181,0
7676,1,0,1,14,296,0.95,156,140
7678,3,0,0,9,139,0,0,139
7679,0,0,2,8,115,0.25,41,74
7680,0,0,9,0,854,5.2,854,0
7681,7,0,0,15,126,0,0,126
7682,0,0,2,9,444,1.58333333333333,260,184
7683,1,0,2,12,219,0.816666666666667,134,85
7684,18,0,0,15,96,0,0,96
7685,2,1,1,16,184,0.133333333333333,22,162
7686,0,3,9,5,610,3.65,599,11
7687,0,1,8,2,594,3.6,590,4
7688,0,0,5,0,255,1.55,255,0
7689,0,0,9,0,600,3.66666666666667,600,0
7690,1,0,0,9,131,0,0,131
7691,2,7,0,14,165,0,0,165
7692,0,0,12,0,403,2.45,403,0
7693,0,0,14,0,429,2.61666666666667,429,0
7694,1,1,0,11,265,0,0,265
7697,0,0,1,12,158,0.15,25,133
7699,2,4,0,20,272,0,0,272
7720,0,0,10,0,547,3.33333333333333,547,0
7724,10,0,0,26,319,0,0,319
7732,3,1,1,12,300,0.733333333333333,120,180
7733,0,0,5,0,330,2.01666666666667,330,0
7737,1,0,0,12,105,0,0,105
7743,1,0,0,12,40,0,0,40
7745,1,0,1,15,267,0.733333333333333,120,147
7747,0,0,9,0,598,3.65,598,0
7750,3,0,0,16,73,0,0,73
7752,0,0,4,0,178,1.08333333333333,178,0
7757,0,0,11,0,570,3.48333333333333,570,0
7768,2,0,1,13,238,0.733333333333333,120,118
7776,7,3,0,23,246,0,0,246
7783,0,1,2,13,143,0.25,41,102
7792,0,0,5,0,238,1.45,238,0
7798,10,0,0,25,264,0,0,264
7800,0,0,6,0,218,1.33333333333333,218,0
7801,0,0,3,0,363,2.21666666666667,363,0
7805,1,0,2,13,148,0.25,41,107
7806,0,0,5,1,317,1.93333333333333,316,1
7811,0,2,0,10,79,0,0,79
7812,4,0,0,19,138,0,0,138
7815,0,0,0,10,60,0,0,60
7819,8,0,0,21,140,0,0,140
7831,0,8,0,14,69,0,0,69
7832,0,0,9,0,612,3.73333333333333,612,0
7834,0,0,4,0,173,1.05,173,0
7841,0,0,9,1,596,3.63333333333333,595,1
7852,9,0,0,15,124,0,0,124
7860,3,1,3,12,336,1.73333333333333,284,52
7866,1,1,0,7,41,0,0,41
7869,0,1,0,8,54,0,0,54
7872,0,0,2,5,197,0.7,115,82
7875,5,0,2,14,211,0.5,82,129
7877,6,0,0,18,117,0,0,117
7880,10,0,0,23,84,0,0,84
7892,5,1,0,17,164,0,0,164
7893,5,0,3,18,782,3.48333333333333,572,210
7896,1,0,11,0,367,2.23333333333333,367,0
7961,0,0,7,0,216,1.31666666666667,216,0
7963,2,3,0,13,181,0,0,181
7964,4,0,0,20,152,0,0,152
7965,2,0,9,8,1020,5.7,935,85
7966,1,2,0,16,291,0,0,291
7967,0,0,8,1,427,2.6,426,1
7968,2,5,0,7,94,0,0,94
7969,7,3,0,26,258,0,0,258
7971,1,4,0,8,70,0,0,70
7972,0,0,5,0,93,0.566666666666667,93,0
7975,2,2,0,7,64,0,0,64
7977,6,4,0,18,269,0,0,269
7978,0,2,4,7,250,1.1,180,70
7980,0,0,4,11,304,1.1,180,124
7981,0,0,2,9,186,0.6,98,88
7983,0,2,0,8,109,0,0,109
7984,0,0,3,7,217,0.8,131,86
7985,0,0,4,0,112,0.683333333333333,112,0
7986,2,4,0,22,391,0,0,391
7987,3,1,3,12,429,2.01666666666667,330,99
7988,3,1,2,15,420,1.41666666666667,233,187
7989,0,1,6,0,374,2.28333333333333,374,0
7991,0,0,2,9,246,1.18333333333333,194,52
7992,0,5,0,15,183,0,0,183
7993,3,5,0,9,94,0,0,94
7994,1,0,2,10,300,1.15,188,112
7995,0,0,2,2,126,0.75,123,3
7996,0,0,4,6,250,1.1,180,70
7997,0,0,8,0,561,3.41666666666667,561,0
7998,0,0,8,0,202,1.23333333333333,202,0
7999,0,0,4,11,274,1.1,180,94
8000,8,0,0,25,366,0,0,366
8001,4,3,0,21,408,0,0,408
8002,2,2,1,15,407,1.1,180,227
8003,0,0,10,0,705,4.3,705,0
8004,2,0,1,11,217,0.733333333333333,120,97
8005,6,1,0,21,341,0,0,341
8006,6,2,0,23,288,0,0,288
8007,0,0,6,2,309,1.86666666666667,305,4
8008,1,1,0,15,199,0,0,199
8009,0,0,2,0,481,2.93333333333333,481,0
8010,2,0,0,19,155,0,0,155
8013,0,3,5,5,380,2.2,361,19
8014,0,0,6,0,491,3,491,0
8015,9,1,0,24,277,0,0,277
8016,0,0,6,0,159,0.966666666666667,159,0
8017,8,3,0,18,222,0,0,222
8021,5,5,0,17,190,0,0,190
8022,0,0,1,6,117,0.3,49,68
8023,0,0,4,8,278,1.1,180,98
8024,0,0,3,5,211,0.8,131,80
8025,11,0,9,0,535,3.26666666666667,535,0
8026,3,2,8,14,719,3.65,599,120
8027,4,0,19,0,923,5.63333333333333,923,0
8028,1,0,0,8,83,0,0,83
8029,4,2,0,15,109,0,0,109
8032,4,3,0,21,279,0,0,279
8034,0,0,0,14,35,0,0,35
8035,0,0,8,0,319,1.95,319,0
8036,2,1,0,17,198,0,0,198
8037,1,2,0,16,169,0,0,169
8039,1,0,0,11,25,0,0,25
8040,6,0,2,11,167,0.5,82,85
8041,0,0,13,0,442,2.7,442,0
8043,2,0,1,12,294,0.733333333333333,120,174
8044,0,0,13,0,498,3.05,498,0
8045,0,0,10,0,384,2.35,384,0
8046,10,0,9,0,588,3.58333333333333,588,0
8047,3,1,0,16,243,0,0,243
8048,3,0,4,14,428,1.66666666666667,272,156
8049,4,0,1,14,252,0.733333333333333,120,132
8050,7,0,12,0,575,3.5,575,0
8051,1,0,0,10,102,0,0,102
8052,3,2,0,13,169,0,0,169
8053,7,0,0,17,101,0,0,101
8055,0,0,1,8,130,0.733333333333333,120,10
8056,0,0,1,9,138,0.733333333333333,120,18
8057,12,1,7,0,252,1.53333333333333,252,0
8058,2,1,6,14,471,1.85,303,168
8059,1,1,0,15,186,0,0,186
8062,0,0,0,8,78,0,0,78
8063,4,0,0,10,113,0,0,113
8064,14,0,4,0,241,1.46666666666667,241,0
8069,1,0,0,11,134,0,0,134
8070,0,1,0,15,216,0,0,216
8072,4,0,2,21,263,0.5,82,181
8073,6,2,2,21,484,1.45,238,246
8075,0,0,11,0,672,4.1,672,0
8077,0,0,0,7,92,0,0,92
8078,0,0,2,8,262,1.21666666666667,199,63
8081,2,0,0,11,89,0,0,89
8083,3,4,0,20,196,0,0,196
8084,6,1,6,23,718,2.95,484,234
8085,13,1,8,0,375,2.28333333333333,375,0
8086,4,1,3,25,698,2.38333333333333,391,307
8087,1,0,1,10,206,0.733333333333333,120,86
8088,8,0,0,12,141,0,0,141
8089,3,0,0,14,145,0,0,145
8091,13,3,7,2,266,1.61666666666667,264,2
8092,12,0,8,0,355,2.16666666666667,355,0
8093,0,1,0,8,74,0,0,74
8094,0,0,6,0,322,1.96666666666667,322,0
8095,1,0,0,14,96,0,0,96
8098,1,0,11,0,279,1.7,279,0
8099,9,0,1,18,197,0.366666666666667,60,137
8100,4,1,0,22,296,0,0,296
8101,6,1,0,20,178,0,0,178
8104,13,0,9,0,629,3.83333333333333,629,0
8105,4,0,0,12,167,0,0,167
8106,0,0,0,11,14,0,0,14
8107,3,1,6,11,416,2.06666666666667,339,77
8109,2,0,0,14,123,0,0,123
8111,8,0,0,18,111,0,0,111
8112,1,0,3,9,247,1.31666666666667,215,32
8113,1,0,0,10,89,0,0,89
8132,1,2,0,18,212,0,0,212
8133,0,0,1,8,114,0.5,82,32
8134,0,0,8,4,305,1.78333333333333,293,12
8135,0,1,0,7,69,0,0,69
8136,0,0,11,0,400,2.43333333333333,400,0
8137,5,2,0,19,150,0,0,150
8139,0,0,4,0,248,1.51666666666667,248,0
8140,0,0,8,0,380,2.31666666666667,380,0
8141,0,0,13,0,871,5.3,871,0
8142,0,0,11,1,513,3.11666666666667,511,2
8143,0,0,4,0,339,2.06666666666667,339,0
8144,1,0,4,5,392,2.23333333333333,367,25
8145,0,0,13,0,626,3.81666666666667,626,0
8146,2,0,1,3,112,0.55,90,22
8147,0,0,6,1,468,2.85,467,1
8148,0,0,4,0,399,2.43333333333333,399,0
8149,0,0,2,1,330,1.95,320,10
8150,0,0,2,9,198,0.5,82,116
8151,0,0,4,6,234,1,164,70
8152,6,0,0,22,220,0,0,220
8153,0,2,0,12,145,0,0,145
8154,0,0,2,0,224,1.36666666666667,224,0
8155,4,8,3,15,621,3.08333333333333,506,115
8156,0,0,3,0,271,1.65,271,0
8157,0,0,8,0,301,1.83333333333333,301,0
8158,1,3,0,11,133,0,0,133
8159,0,0,13,0,671,4.08333333333333,671,0
8160,0,0,8,0,462,2.81666666666667,462,0
8161,1,0,0,9,54,0,0,54
8162,4,5,0,18,362,0,0,362
8163,0,0,10,0,475,2.9,475,0
8164,5,0,3,13,586,2.36666666666667,389,197
8165,10,11,2,21,967,5.06666666666667,831,136
8166,1,0,2,9,230,0.916666666666667,150,80
8167,2,1,0,20,218,0,0,218
8168,1,0,9,1,1026,6.23333333333333,1024,2
8169,0,0,0,8,97,0,0,97
8170,0,0,11,0,654,3.98333333333333,654,0
8171,2,0,2,21,288,0.5,82,206
8172,6,0,2,17,199,0.5,82,117
8173,6,0,0,12,113,0,0,113
8174,0,5,0,5,73,0,0,73
8175,4,1,0,10,96,0,0,96
8176,0,0,0,1,8,0,0,8
8177,0,2,0,4,47,0,0,47
8178,6,0,1,11,145,0.2,33,112
8179,0,0,11,0,592,3.61666666666667,592,0
8180,0,1,0,5,45,0,0,45
8181,6,2,0,21,350,0,0,350
8182,0,3,0,9,173,0,0,173
8183,0,0,9,0,540,3.3,540,0
8184,6,3,0,22,244,0,0,244
8185,0,0,1,9,148,0.5,82,66
8186,10,0,0,26,201,0,0,201
8187,0,0,1,9,152,0.733333333333333,120,32
8188,3,0,2,14,195,0.5,82,113
8189,0,1,0,18,285,0,0,285
8190,0,0,1,10,230,0.733333333333333,120,110
8191,1,0,4,8,181,0.6,98,83
8192,0,0,0,8,85,0,0,85
8193,1,0,0,14,63,0,0,63
8194,6,5,0,24,399,0,0,399
8195,6,0,0,19,168,0,0,168
8196,9,3,0,24,359,0,0,359
8197,2,2,4,7,304,1.03333333333333,171,133
8198,2,0,0,15,173,0,0,173
8199,4,1,0,24,288,0,0,288
8200,5,0,1,4,94,0.316666666666667,52,42
8201,5,0,1,26,276,0.316666666666667,52,224
8202,8,0,2,24,304,0.5,82,222
8203,1,1,0,19,201,0,0,201
8204,2,0,1,19,254,0.75,123,131
8205,0,2,0,7,53,0,0,53
8206,7,7,0,20,216,0,0,216
8207,0,0,11,0,439,2.68333333333333,439,0
8208,5,1,7,5,741,4.36666666666667,716,25
8209,0,0,1,6,120,0.2,33,87
8210,0,0,0,13,167,0,0,167
8211,4,1,0,23,431,0,0,431
8212,0,0,0,6,32,0,0,32
8213,1,0,0,9,52,0,0,52
8214,0,0,2,6,154,0.5,82,72
8215,0,0,10,0,621,3.78333333333333,621,0
8216,3,3,0,23,380,0,0,380
8219,0,2,0,6,70,0,0,70
8220,0,3,0,10,78,0,0,78
8221,5,0,2,16,173,0.383333333333333,63,110
8222,0,0,12,0,554,3.36666666666667,554,0
8223,0,0,5,2,419,2.53333333333333,415,4
8224,2,0,1,14,151,0.483333333333333,79,72
8225,0,0,10,0,477,2.91666666666667,477,0
8226,0,3,0,10,80,0,0,80
8227,0,0,0,19,268,0,0,268
8228,0,0,2,7,158,0.6,98,60
8229,0,0,0,9,116,0,0,116
8230,2,0,2,16,229,0.5,82,147
8231,5,10,4,19,1015,5.31666666666667,873,142
8232,0,0,3,0,193,1.18333333333333,193,0
8233,0,1,0,8,137,0,0,137
8234,7,3,0,20,255,0,0,255
8235,2,0,2,10,325,1.56666666666667,257,68
8236,1,1,13,1,557,3.4,556,1
8237,0,1,0,6,47,0,0,47
8238,0,0,12,0,847,5.16666666666667,847,0
8239,0,0,7,0,589,3.58333333333333,589,0
8240,1,3,0,15,259,0,0,259
8241,0,0,11,0,474,2.9,474,0
8242,2,0,2,13,184,0.633333333333333,104,80
8243,0,0,0,9,68,0,0,68
8244,4,0,0,13,110,0,0,110
8245,0,0,2,0,369,2.25,369,0
8246,0,4,0,9,115,0,0,115
8247,0,0,1,11,160,0.5,82,78
8248,0,0,1,9,142,0.5,82,60
8250,4,5,0,26,289,0,0,289
8251,0,0,2,20,250,0.5,82,168
8252,0,0,3,0,353,2.15,353,0
8253,0,0,8,0,316,1.93333333333333,316,0
8254,0,0,7,0,448,2.73333333333333,448,0
8258,2,4,0,21,372,0,0,372
8259,0,0,12,0,594,3.61666666666667,594,0
8260,0,0,5,0,265,1.61666666666667,265,0
8261,0,0,12,1,376,2.26666666666667,372,4
8262,6,1,0,27,378,0,0,378
8263,0,0,2,0,145,0.883333333333333,145,0
8264,4,0,0,18,144,0,0,144
8265,0,0,5,0,364,2.21666666666667,364,0
8266,0,0,10,1,413,2.51666666666667,412,1
8267,0,0,9,0,481,2.93333333333333,481,0
8268,13,3,6,5,434,2.53333333333333,416,18
8269,0,2,0,13,162,0,0,162
8270,1,0,1,8,184,0.733333333333333,120,64
8273,0,0,1,9,141,0.3,49,92
8274,1,0,0,17,220,0,0,220
8275,0,0,8,0,459,2.8,459,0
8276,6,0,3,15,640,3.15,516,124
8277,7,3,0,17,211,0,0,211
8278,4,0,2,12,208,0.5,82,126
8279,0,4,0,10,176,0,0,176
8280,2,0,0,7,58,0,0,58
8281,0,2,0,5,45,0,0,45
8282,0,0,7,2,343,2.08333333333333,341,2
8283,7,0,0,19,194,0,0,194
8284,1,0,1,7,121,0.5,82,39
8285,1,1,1,11,196,0.733333333333333,120,76
8286,0,0,13,0,937,5.71666666666667,937,0
8288,13,0,2,18,243,0.516666666666667,85,158
8289,0,0,3,11,222,0.7,115,107
8290,0,0,9,0,427,2.61666666666667,427,0
8291,4,2,0,6,91,0,0,91
8292,1,0,5,8,480,2.41666666666667,395,85
8293,0,0,8,0,610,3.71666666666667,610,0
8294,0,5,0,11,127,0,0,127
8295,2,0,3,6,164,0.6,98,66
8296,12,2,1,8,246,1.11666666666667,183,63
8298,0,0,1,7,125,0.3,49,76
8299,0,0,1,11,177,0.5,82,95
8300,3,3,0,13,144,0,0,144
8301,0,1,0,10,95,0,0,95
8302,8,4,2,5,603,3.58333333333333,588,15
8303,4,0,0,19,117,0,0,117
8304,0,0,2,12,163,0.5,82,81
8305,6,2,1,18,413,1.1,180,233
8306,4,3,0,22,335,0,0,335
8307,9,0,2,12,204,0.516666666666667,85,119
8308,0,0,12,0,855,5.21666666666667,855,0
8309,0,0,5,0,491,3,491,0
8310,0,0,0,10,108,0,0,108
8311,3,2,0,12,247,0,0,247
8312,0,0,4,0,526,3.2,526,0
8313,3,0,2,14,182,0.516666666666667,85,97
8315,0,1,0,10,102,0,0,102
8316,0,0,1,7,119,0.3,49,70
8317,0,0,0,9,44,0,0,44
8318,0,0,3,0,192,1.16666666666667,192,0
8319,0,0,6,4,199,1.18333333333333,193,6
8320,0,0,1,12,217,1.01666666666667,167,50
8321,0,4,0,9,79,0,0,79
8322,0,2,0,9,132,0,0,132
8323,1,2,6,6,661,3.35,549,112
8324,16,4,2,10,152,0.683333333333333,112,40
8325,3,3,1,12,411,1.96666666666667,323,88
8326,1,0,1,12,180,0.366666666666667,60,120
8327,2,0,2,18,234,0.5,82,152
8328,2,0,1,12,178,0.733333333333333,120,58
8329,0,0,3,7,200,0.8,131,69
8330,1,5,1,8,192,0.3,49,143
8331,2,0,0,17,156,0,0,156
8332,2,0,0,15,135,0,0,135
8333,0,0,15,0,707,4.31666666666667,707,0
8334,3,0,3,9,188,0.9,148,40
8335,0,0,2,0,109,0.666666666666667,109,0
8336,2,2,0,10,147,0,0,147
8338,0,0,6,0,543,3.31666666666667,543,0
8339,0,0,0,4,21,0,0,21
8340,0,0,3,10,349,1.45,238,111
8341,4,0,0,10,99,0,0,99
8342,0,0,6,0,211,1.28333333333333,211,0
8343,8,0,0,15,139,0,0,139
8344,7,0,0,20,158,0,0,158
8345,1,2,0,15,149,0,0,149
8346,1,0,0,13,79,0,0,79
8347,0,0,6,2,360,2.11666666666667,347,13
8348,0,0,5,0,470,2.86666666666667,470,0
8349,0,0,11,1,558,3.4,557,1
8350,0,0,3,0,260,1.58333333333333,260,0
8351,9,2,5,6,961,5.5,902,59
8352,1,0,3,11,525,2.4,394,131
8353,7,5,0,16,285,0,0,285
8354,1,0,11,0,524,3.2,524,0
8355,1,0,1,11,155,0.5,82,73
8356,1,0,1,12,150,0.383333333333333,63,87
8357,1,0,0,5,33,0,0,33
8358,0,0,4,0,371,2.26666666666667,371,0
8359,0,0,9,0,544,3.31666666666667,544,0
8360,3,3,9,5,1114,6.65,1090,24
8361,0,0,6,2,395,2.35,385,10
8362,0,0,1,9,162,0.5,82,80
8363,1,0,2,8,318,1.5,246,72
8364,0,0,14,0,509,3.1,509,0
8365,6,0,0,19,180,0,0,180
8366,8,4,0,24,293,0,0,293
8368,1,1,8,6,683,3.43333333333333,563,120
8369,0,0,4,0,251,1.53333333333333,251,0
8372,4,0,2,11,125,0.5,82,43
8373,5,0,4,8,246,1.01666666666667,167,79
8374,0,0,0,10,39,0,0,39
8375,2,0,2,8,171,0.5,82,89
8376,0,0,3,0,221,1.35,221,0
8377,1,2,4,9,524,2.31666666666667,380,144
8378,8,2,0,20,297,0,0,297
8379,16,7,0,12,140,0,0,140
8380,0,0,9,0,666,4.06666666666667,666,0
8381,4,0,3,15,216,0.7,115,101
8382,5,0,0,23,233,0,0,233
8383,4,0,2,9,182,0.5,82,100
8384,1,0,0,11,97,0,0,97
8385,1,0,3,10,296,1.16666666666667,191,105
8387,5,0,0,15,107,0,0,107
8388,10,0,1,8,108,0.2,33,75
8389,2,0,5,6,125,0.666666666666667,110,15
8390,0,0,3,8,195,0.883333333333333,145,50
8391,0,6,0,14,153,0,0,153
8392,0,3,10,6,861,5.01666666666667,822,39
8393,0,0,1,10,153,0.733333333333333,120,33
8394,5,1,0,21,234,0,0,234
8395,0,0,7,0,340,2.06666666666667,340,0
8396,0,0,13,0,744,4.53333333333333,744,0
8397,2,0,0,19,155,0,0,155
8398,0,0,1,7,100,0.2,33,67
8399,1,0,1,9,154,0.733333333333333,120,34
8400,14,2,1,7,123,0.4,66,57
8401,0,0,2,0,180,1.1,180,0
8402,1,1,0,14,115,0,0,115
8403,5,6,0,18,276,0,0,276
8404,1,0,2,13,364,1.9,311,53
8405,0,0,12,1,347,2.11666666666667,346,1
8406,6,4,0,26,359,0,0,359
8407,0,0,4,0,330,2.01666666666667,330,0
8408,4,0,2,23,306,0.5,82,224
8409,1,0,5,2,362,2.11666666666667,348,14
8410,0,0,1,0,230,1.4,230,0
8411,0,1,0,10,172,0,0,172
8412,0,0,2,9,273,0.5,82,191
8413,3,4,6,9,777,4.45,730,47
8414,1,0,0,11,56,0,0,56
8415,0,0,0,8,57,0,0,57
8416,2,0,1,19,245,0.316666666666667,52,193
8417,6,0,2,12,178,0.5,82,96
8418,1,0,0,15,157,0,0,157
8419,4,1,2,10,298,1.53333333333333,251,47
8420,0,0,0,9,59,0,0,59
8421,0,0,10,0,465,2.83333333333333,465,0
8422,0,0,1,12,186,0.2,33,153
8423,0,0,1,10,165,0.2,33,132
8424,1,1,8,2,798,4.66666666666667,764,34
8425,0,0,10,0,538,3.28333333333333,538,0
8426,0,0,0,6,34,0,0,34
8427,0,0,1,8,98,0.2,33,65
8428,8,1,1,18,309,1.33333333333333,219,90
8429,0,0,1,11,172,0.2,33,139
8430,0,0,1,9,238,0.733333333333333,120,118
8431,4,2,0,24,391,0,0,391
8432,0,0,1,8,120,0.2,33,87
8433,2,0,2,14,236,0.5,82,154
8434,0,0,12,0,622,3.8,622,0
8435,5,0,0,14,141,0,0,141
8437,3,9,0,22,131,0,0,131
8439,1,1,0,6,71,0,0,71
8451,2,0,10,2,807,4.43333333333333,726,81
8452,0,0,4,0,260,1.58333333333333,260,0
8453,0,0,12,4,876,5.2,854,22
8454,0,0,4,0,380,2.31666666666667,380,0
8455,0,0,4,0,315,1.91666666666667,315,0
8457,5,0,1,14,205,0.316666666666667,52,153
8458,0,0,1,10,71,0.1,16,55
8459,0,0,6,0,355,2.16666666666667,355,0
8460,0,0,10,0,254,1.55,254,0
8461,0,0,2,8,244,1.2,197,47
8462,0,0,0,13,107,0,0,107
8463,0,0,3,0,189,1.15,189,0
8465,4,0,2,18,227,0.5,82,145
8466,2,0,2,7,137,0.5,82,55
8467,0,1,10,1,574,3.5,573,1
8468,7,0,11,0,533,3.25,533,0
8469,0,0,11,0,343,2.08333333333333,343,0
8471,0,0,0,8,61,0,0,61
8473,0,0,6,0,353,2.15,353,0
8474,3,0,2,9,293,1.23333333333333,202,91
8475,1,0,5,3,525,3.1,508,17
8476,1,0,3,10,426,1.88333333333333,309,117
8477,1,0,2,10,272,1.01666666666667,166,106
8478,0,0,1,10,201,0.733333333333333,120,81
8480,0,0,3,10,166,0.4,66,100
8481,0,0,8,2,275,1.55,253,22
8482,0,2,0,9,62,0,0,62
8483,2,0,2,10,179,0.5,82,97
8484,0,1,7,0,394,2.4,394,0
8486,0,0,0,10,103,0,0,103
8487,0,0,12,5,1369,8.18333333333333,1342,27
8489,0,2,0,7,55,0,0,55
8490,0,0,0,9,39,0,0,39
8491,7,2,0,11,109,0,0,109
8493,0,0,10,0,560,3.41666666666667,560,0
8494,2,0,5,5,478,2.73333333333333,449,29
8495,1,0,4,10,559,2.9,475,84
8496,2,1,0,17,339,0,0,339
8497,4,0,0,15,112,0,0,112
8498,0,0,0,9,75,0,0,75
8499,12,0,2,9,126,0.5,82,44
8500,1,0,9,5,1158,6.43333333333333,1055,103
8501,2,0,5,7,351,1.76666666666667,289,62
8502,0,0,3,0,225,1.36666666666667,225,0
8503,0,0,2,11,145,0.25,41,104
8504,6,1,0,20,239,0,0,239
8505,2,0,3,11,404,1.63333333333333,267,137
8506,3,3,0,23,260,0,0,260
8507,0,1,1,12,122,0.15,25,97
8508,5,0,2,5,115,0.5,82,33
8509,1,0,0,15,254,0,0,254
8510,2,1,0,12,146,0,0,146
8511,5,0,3,16,224,0.7,115,109
8512,0,0,4,0,232,1.41666666666667,232,0
8513,1,6,0,24,312,0,0,312
8514,1,1,1,11,108,0.15,25,83
8515,4,3,0,21,366,0,0,366
8516,2,0,4,1,89,0.533333333333333,87,2
8517,9,0,1,7,63,0.183333333333333,30,33
8518,8,0,2,16,260,0.516666666666667,85,175
8519,0,0,11,0,241,1.46666666666667,241,0
8520,4,0,0,19,249,0,0,249
8521,0,0,8,1,447,2.71666666666667,445,2
8522,7,2,8,0,473,2.88333333333333,473,0
8523,0,0,4,0,186,1.13333333333333,186,0
8524,0,1,10,6,746,4.3,705,41
8525,2,1,1,7,57,0.0666666666666667,11,46
8526,4,0,0,21,233,0,0,233
8527,0,0,1,10,113,0.15,25,88
8528,0,0,7,0,396,2.41666666666667,396,0
8529,0,0,0,11,146,0,0,146
8530,1,1,2,8,331,1.28333333333333,210,121
8531,1,1,4,8,655,3.23333333333333,530,125
8532,0,0,2,12,95,0.25,41,54
8533,9,0,10,0,520,3.16666666666667,520,0
8534,11,0,1,9,111,0.316666666666667,52,59
8535,0,0,13,0,1002,6.11666666666667,1002,0
8536,1,0,0,17,195,0,0,195
8537,0,0,3,0,419,2.55,419,0
8538,0,1,2,0,109,0.666666666666667,109,0
8540,0,0,5,5,233,1.13333333333333,185,48
8541,1,1,12,5,879,5.18333333333333,851,28
8543,11,1,6,0,407,2.48333333333333,407,0
8544,0,0,6,0,543,3.31666666666667,543,0
8545,4,1,0,16,161,0,0,161
8546,2,1,8,5,432,2.38333333333333,391,41
8547,0,0,2,0,375,2.28333333333333,375,0
8548,5,3,0,8,141,0,0,141
8549,0,0,4,0,72,0.433333333333333,72,0
8551,2,0,15,6,1414,7.95,1304,110
8552,1,0,0,8,44,0,0,44
8553,0,0,3,0,123,0.75,123,0
8554,6,4,0,16,214,0,0,214
8555,1,2,0,21,314,0,0,314
8556,4,0,3,14,261,0.7,115,146
8557,0,0,3,0,244,1.48333333333333,244,0
8558,0,0,1,0,79,0.483333333333333,79,0
8560,0,0,0,11,111,0,0,111
8561,1,1,0,18,303,0,0,303
8562,1,0,6,5,578,2.95,483,95
8563,2,0,0,16,195,0,0,195
8564,4,4,1,11,269,0.566666666666667,93,176
8565,0,0,6,0,375,2.28333333333333,375,0
8567,4,0,0,17,174,0,0,174
8568,7,0,8,0,511,3.11666666666667,511,0
8569,3,0,0,12,119,0,0,119
8570,3,0,0,19,199,0,0,199
8571,1,0,5,1,121,0.733333333333333,120,1
8572,0,0,7,1,519,3.16666666666667,518,1
8574,1,1,0,18,311,0,0,311
8575,1,2,0,10,101,0,0,101
8576,0,0,0,10,109,0,0,109
8577,1,4,0,22,327,0,0,327
8578,0,0,6,6,758,4.4,722,36
8579,0,0,5,0,323,1.96666666666667,323,0
8580,4,0,1,7,126,0.316666666666667,52,74
8581,0,1,0,10,155,0,0,155
8582,1,0,1,11,187,0.65,107,80
8583,0,0,10,3,551,3.35,548,3
8584,1,0,5,1,393,2.11666666666667,347,46
8586,0,0,8,2,264,1.38333333333333,226,38
8587,3,0,0,19,239,0,0,239
8588,1,0,5,7,585,3.26666666666667,536,49
8589,5,0,0,13,130,0,0,130
8590,0,0,0,11,44,0,0,44
8591,3,1,0,11,103,0,0,103
8592,4,0,3,25,314,0.7,115,199
8593,0,0,1,11,103,0.15,25,78
8594,5,1,0,25,340,0,0,340
8595,2,0,4,8,436,2.1,344,92
8596,3,0,2,11,167,0.583333333333333,95,72
8597,4,0,0,8,36,0,0,36
8598,0,0,1,10,149,0.2,33,116
8599,0,0,2,10,253,0.983333333333333,161,92
8600,4,0,0,11,80,0,0,80
8601,1,1,0,18,339,0,0,339
8602,0,0,0,5,62,0,0,62
8603,0,0,0,8,119,0,0,119
8604,4,2,0,17,278,0,0,278
8605,1,1,0,14,245,0,0,245
8606,10,0,8,1,306,1.86666666666667,305,1
8607,0,0,7,0,501,3.05,501,0
8608,0,0,4,0,175,1.06666666666667,175,0
8610,0,2,1,12,121,0.15,25,96
8613,0,1,1,11,160,0.2,33,127
8614,0,0,13,0,421,2.56666666666667,421,0
8615,0,0,4,0,295,1.8,295,0
8616,0,1,0,8,26,0,0,26
8617,0,0,0,9,86,0,0,86
8618,0,0,0,12,138,0,0,138
8619,3,1,0,14,181,0,0,181
8620,0,0,8,4,245,1.36666666666667,224,21
8622,5,0,3,12,215,0.7,115,100
8623,2,0,1,14,156,0.183333333333333,30,126
8624,0,0,11,0,132,0.816666666666667,132,0
8626,1,0,0,15,136,0,0,136
8627,0,0,1,4,103,0.5,82,21
8628,0,0,2,10,253,0.983333333333333,161,92
8629,0,1,0,13,215,0,0,215
8630,2,0,1,12,162,0.733333333333333,120,42
8631,9,0,7,0,266,1.61666666666667,266,0
8632,11,0,9,0,382,2.33333333333333,382,0
8633,0,0,5,0,312,1.9,312,0
8634,3,0,2,18,188,0.516666666666667,85,103
8635,1,1,0,4,46,0,0,46
8636,5,2,0,18,267,0,0,267
8637,4,0,0,9,70,0,0,70
8638,0,2,5,0,506,3.08333333333333,506,0
8639,0,1,0,10,109,0,0,109
8640,0,0,4,0,172,1.05,172,0
8641,0,0,12,0,230,1.41666666666667,230,0
8642,0,0,1,11,101,0.15,25,76
8643,2,0,0,8,63,0,0,63
8644,11,0,6,0,156,0.95,156,0
8646,2,0,1,13,197,0.316666666666667,52,145
8647,0,0,12,0,306,1.86666666666667,306,0
8648,0,0,1,10,146,0.316666666666667,52,94
8649,3,0,0,12,57,0,0,57
8650,9,0,7,0,371,2.26666666666667,371,0
8652,0,0,19,0,358,2.2,358,0
8653,0,0,12,0,349,2.13333333333333,349,0
8654,0,0,12,0,203,1.23333333333333,203,0
8655,0,0,15,0,383,2.35,383,0
8656,0,0,14,0,243,1.5,243,0
8657,0,0,17,0,320,1.96666666666667,320,0
8658,0,0,13,0,405,2.48333333333333,405,0
8659,0,0,16,0,400,2.45,400,0
8660,0,0,10,0,387,2.36666666666667,387,0
8663,0,1,1,12,121,0.15,25,96
8664,0,1,1,15,138,0.15,25,113
8665,0,1,0,12,87,0,0,87
8666,0,0,2,16,174,0.25,41,133
8667,0,0,1,13,110,0.15,25,85
8669,0,0,1,15,110,0.15,25,85
8670,0,0,2,17,132,0.25,41,91
8671,0,0,1,13,122,0.15,25,97
8672,0,2,2,12,122,0.25,41,81
8680,2,0,0,19,107,0,0,107
8681,2,5,5,2,439,2.63333333333333,431,8
8682,0,6,8,0,2255,13.75,2255,0
8683,1,21,23,3,1216,7.36666666666667,1209,7
8684,4,1,8,1,450,2.73333333333333,449,1
8685,0,5,8,7,687,4,656,31
8686,0,4,10,0,729,4.45,729,0
8687,0,0,29,0,2010,12.2666666666667,2010,0
8688,0,6,14,0,912,5.56666666666667,912,0
8689,0,0,29,0,1210,7.36666666666667,1210,0
8690,0,11,15,3,1329,8.05,1320,9
8691,0,15,19,4,842,5.03333333333333,827,15
8692,4,5,6,7,455,2.53333333333333,416,39
8693,2,15,8,1,2769,16.8833333333333,2768,1
8694,2,4,5,3,625,3.6,591,34
8695,0,0,25,0,1498,9.11666666666667,1498,0
8696,10,3,20,12,3190,18.85,3093,97
8697,1,10,10,1,2008,12.2333333333333,2007,1
8698,0,2,5,1,348,2.11666666666667,347,1
8699,0,0,25,0,1606,9.78333333333333,1606,0
8701,2,8,5,8,359,1.88333333333333,308,51
8703,4,3,1,3,223,1.26666666666667,208,15
8704,0,0,28,0,2377,14.4833333333333,2377,0
8705,0,15,12,7,836,4.8,787,49
8706,9,17,0,50,474,0,0,474
8707,2,8,10,1,1863,11.35,1862,1
8709,12,7,9,22,1805,9.7,1590,215
8710,0,6,9,0,1771,10.8,1771,0
8711,0,19,7,17,399,1.95,319,80
8712,0,2,8,0,640,3.9,640,0
8713,7,4,15,15,2276,12.3166666666667,2021,255
8714,0,0,23,0,1129,6.88333333333333,1129,0
8716,15,20,0,42,456,0,0,456
8717,0,0,29,0,1762,10.75,1762,0
8718,25,11,1,28,801,3.38333333333333,555,246
8719,0,10,10,3,550,3.33333333333333,546,4
8720,3,7,9,1,1950,11.8833333333333,1948,2
8721,11,17,6,25,1624,8.56666666666667,1405,219
8722,0,11,5,10,417,2.11666666666667,348,69
8724,1,17,9,10,435,2.28333333333333,374,61
8725,0,6,8,5,1212,7.35,1207,5
8726,0,9,13,1,454,2.73333333333333,448,6
8727,3,2,4,1,406,2.46666666666667,405,1
8728,0,7,18,2,1452,8.85,1448,4
8730,0,16,14,9,1038,6.03333333333333,988,50
8731,0,0,28,0,1870,11.4,1870,0
8732,0,13,19,1,1141,6.95,1139,2
8733,13,5,13,19,1919,10.6,1739,180
8734,0,1,5,0,864,5.26666666666667,864,0
8735,2,9,8,0,2676,16.3166666666667,2676,0
8736,0,8,8,0,1953,11.9166666666667,1953,0
8737,0,0,20,0,1252,7.63333333333333,1252,0
8738,0,1,13,0,768,4.68333333333333,768,0
8739,3,3,8,2,715,4.33333333333333,711,4
8741,1,17,10,10,947,5.46666666666667,898,49
8742,11,14,4,23,1720,9.33333333333333,1530,190
8743,0,0,36,0,2768,16.8833333333333,2768,0
8744,9,24,0,40,573,0,0,573
8745,3,1,2,6,188,0.8,132,56
8747,0,1,6,0,391,2.38333333333333,391,0
8750,0,5,12,0,534,3.25,534,0
8751,12,7,18,16,2739,15.25,2502,237
8752,0,4,16,1,871,5.31666666666667,870,1
8753,0,2,16,0,1390,8.48333333333333,1390,0
8755,1,0,1,19,236,0.316666666666667,52,184
8756,3,0,4,15,283,0.883333333333333,145,138
8757,0,0,0,10,201,0,0,201
8758,0,7,0,14,186,0,0,186
8759,2,2,0,22,258,0,0,258
8761,0,4,0,12,181,0,0,181
8762,8,9,12,16,2681,15.4,2526,155
8763,18,17,0,38,709,0,0,709
8764,2,6,4,3,458,2.7,443,15
8765,0,0,1,12,214,0.5,82,132
8766,0,0,1,14,205,0.5,82,123
8767,0,5,7,0,1889,11.5166666666667,1889,0
8768,0,17,12,12,868,4.86666666666667,799,69
8769,0,2,10,0,672,4.1,672,0
8770,0,5,13,0,1089,6.63333333333333,1089,0
8777,0,1,14,0,954,5.81666666666667,954,0
8778,0,3,7,0,610,3.71666666666667,610,0
8779,1,7,6,1,1865,11.3666666666667,1864,1
8780,0,1,11,0,743,4.53333333333333,743,0
8781,0,0,1,0,57,0.35,57,0
8783,0,0,6,7,268,1.48333333333333,243,25
8784,0,0,11,3,651,3.86666666666667,633,18
8785,0,0,1,11,137,0.5,82,55
8786,0,0,4,9,289,1.58333333333333,260,29
8787,1,0,1,6,37,0.15,25,12
8789,1,0,4,0,765,4.66666666666667,765,0
8790,0,0,5,0,251,1.53333333333333,251,0
8797,0,1,4,2,285,1.7,278,7
8798,1,0,2,3,267,1.58333333333333,259,8
8800,1,0,10,7,617,3.31666666666667,544,73
8801,0,1,8,6,715,3.23333333333333,529,186
8802,2,3,3,7,447,2.06666666666667,339,108
8805,2,0,1,11,152,0.466666666666667,77,75
8806,0,0,0,7,106,0,0,106
8807,0,0,6,0,325,1.98333333333333,325,0
8808,0,0,14,0,339,2.06666666666667,339,0
8809,0,0,1,3,107,0.5,82,25
8810,0,0,12,0,764,4.66666666666667,764,0
8811,0,0,4,8,422,1.96666666666667,322,100
8813,0,1,0,11,60,0,0,60
8814,5,0,2,11,166,0.516666666666667,85,81
8815,8,0,2,17,262,0.383333333333333,63,199
8817,0,0,12,0,143,0.883333333333333,143,0
8821,0,0,12,0,318,1.93333333333333,318,0
8823,4,0,0,15,121,0,0,121
8824,10,0,5,0,283,1.71666666666667,283,0
8825,6,6,0,13,147,0,0,147
8826,0,0,1,10,154,0.5,82,72
8827,1,0,0,7,21,0,0,21
8840,5,0,1,13,124,0.2,33,91
8841,6,10,0,14,199,0,0,199
8842,7,1,0,16,96,0,0,96
8843,0,0,0,8,73,0,0,73
8844,8,0,1,25,310,0.383333333333333,63,247
8845,2,0,0,16,83,0,0,83
8846,6,2,0,10,187,0,0,187
8847,0,1,1,10,196,0.366666666666667,60,136
8848,0,0,5,0,205,1.25,205,0
8849,1,1,0,12,143,0,0,143
8850,13,0,2,5,178,0.933333333333333,153,25
8852,4,2,0,17,159,0,0,159
8853,0,0,1,0,273,1.66666666666667,273,0
8854,9,2,6,0,437,2.66666666666667,437,0
8855,0,0,9,0,413,2.51666666666667,413,0
8856,7,0,2,18,398,1.58333333333333,260,138
8857,8,1,0,5,154,0,0,154
8858,1,0,3,5,75,0.333333333333333,55,20
8859,3,0,1,8,159,0.35,57,102
8860,0,0,5,0,314,1.91666666666667,314,0
8861,0,0,0,7,47,0,0,47
8862,0,0,1,0,282,1.71666666666667,282,0
8863,0,0,0,9,86,0,0,86
8864,0,0,4,0,248,1.51666666666667,248,0
8865,0,1,0,10,95,0,0,95
8866,0,0,1,0,314,1.91666666666667,314,0
8867,3,0,0,15,109,0,0,109
8868,0,0,0,7,38,0,0,38
8869,0,0,1,4,83,0.333333333333333,55,28
8870,2,1,4,7,232,1.08333333333333,177,55
8871,0,0,0,8,91,0,0,91
8872,4,2,0,10,203,0,0,203
8873,0,1,1,0,167,1.01666666666667,167,0
8874,0,0,6,0,295,1.8,295,0
8875,3,2,0,10,194,0,0,194
8876,1,1,0,10,76,0,0,76
8877,2,0,2,10,167,0.883333333333333,145,22
8878,0,0,6,3,335,1.71666666666667,281,54
8879,1,3,0,11,78,0,0,78
8880,3,0,0,19,145,0,0,145
8881,10,0,4,0,292,1.78333333333333,292,0
8882,1,0,1,8,57,0.233333333333333,38,19
8883,12,0,5,0,230,1.4,230,0
8884,0,0,0,8,117,0,0,117
8886,0,0,0,8,93,0,0,93
8887,3,1,2,11,475,2.16666666666667,355,120
8889,15,0,2,17,382,1.83333333333333,301,81
8890,5,0,1,12,214,0.633333333333333,104,110
8891,1,2,5,10,389,1.93333333333333,318,71
8892,2,1,0,19,185,0,0,185
8893,0,0,1,9,105,0.183333333333333,30,75
8895,0,1,0,6,55,0,0,55
8896,8,0,1,28,325,0.383333333333333,63,262
8897,7,0,1,20,372,0.116666666666667,19,353
8898,0,0,0,6,55,0,0,55
8900,3,0,0,21,145,0,0,145
8901,0,0,0,9,79,0,0,79
8902,0,0,0,11,18,0,0,18
8903,0,0,1,9,58,0.3,49,9
8904,2,3,3,5,343,1.6,262,81
8905,0,0,0,11,55,0,0,55
8906,3,0,0,8,133,0,0,133
8907,0,1,0,7,95,0,0,95
8908,2,0,0,14,111,0,0,111
8909,4,2,0,12,204,0,0,204
8911,0,0,8,1,249,1.33333333333333,219,30
8912,0,0,6,1,269,1.55,254,15
8913,0,0,3,4,189,1.03333333333333,170,19
8914,0,0,3,0,131,0.8,131,0
8915,11,0,6,0,362,2.2,362,0
8916,11,0,1,4,68,0.116666666666667,19,49
8917,0,0,0,6,63,0,0,63
8918,0,0,0,11,74,0,0,74
8919,2,1,0,14,111,0,0,111
8920,2,0,2,10,132,0.4,65,67
8921,0,4,0,14,236,0,0,236
8922,0,0,1,0,221,1.35,221,0
8923,4,3,1,16,255,0.766666666666667,126,129
8924,0,0,4,0,237,1.45,237,0
8925,1,0,2,9,81,0.416666666666667,68,13
8926,0,1,0,11,134,0,0,134
8927,0,0,8,1,346,2.01666666666667,331,15
8928,2,0,0,13,128,0,0,128
8929,17,0,1,13,153,0.633333333333333,104,49
8931,5,0,0,6,103,0,0,103
8932,2,1,0,9,115,0,0,115
8933,0,0,1,0,112,0.683333333333333,112,0
8934,0,2,0,14,91,0,0,91
8935,0,0,2,0,215,1.31666666666667,215,0
8936,0,0,0,7,86,0,0,86
8937,0,0,0,12,52,0,0,52
8938,0,1,0,2,26,0,0,26
8939,0,0,0,4,25,0,0,25
8940,3,2,0,17,128,0,0,128
8941,7,0,0,14,136,0,0,136
8942,0,2,0,10,118,0,0,118
8943,0,0,6,0,416,2.53333333333333,416,0
8944,0,0,9,1,596,3.6,591,5
8945,0,0,4,1,319,1.93333333333333,318,1
8946,9,0,5,1,375,2.28333333333333,374,1
8947,1,4,0,12,144,0,0,144
8949,0,0,0,6,55,0,0,55
8950,0,0,4,2,231,1.13333333333333,186,45
8951,11,0,2,12,203,0.95,156,47
8952,0,0,0,13,148,0,0,148
8953,0,0,4,0,334,2.03333333333333,334,0
8954,0,0,4,5,216,1.01666666666667,166,50
8955,0,0,0,8,130,0,0,130
8956,0,0,0,4,9,0,0,9
8957,2,0,2,10,195,0.883333333333333,145,50
8958,3,0,0,10,179,0,0,179
8959,0,0,3,0,210,1.28333333333333,210,0
8960,0,0,0,15,167,0,0,167
8961,6,0,0,12,86,0,0,86
8962,6,3,0,16,111,0,0,111
8963,9,0,0,16,193,0,0,193
8964,11,0,2,12,228,1.15,189,39
8965,0,0,1,0,161,0.983333333333333,161,0
8966,9,0,0,2,24,0,0,24
8967,0,0,8,3,298,1.53333333333333,251,47
8968,0,0,0,7,91,0,0,91
8969,4,0,3,7,220,1.03333333333333,170,50
8970,0,0,6,3,244,1.13333333333333,186,58
8971,0,0,5,2,275,1.66666666666667,273,2
8972,4,0,1,15,232,0.616666666666667,101,131
8973,0,0,2,1,77,0.416666666666667,69,8
8974,0,0,0,10,46,0,0,46
8975,0,0,5,0,260,1.58333333333333,260,0
8976,1,2,4,6,396,1.93333333333333,318,78
8977,0,1,0,9,80,0,0,80
8978,2,2,0,15,109,0,0,109
8979,4,0,0,12,136,0,0,136
8980,4,0,0,15,150,0,0,150
8981,3,4,0,11,118,0,0,118
8982,9,2,0,25,292,0,0,292
8983,1,0,0,11,57,0,0,57
8984,3,1,0,18,113,0,0,113
8985,1,1,7,1,272,1.65,271,1
8986,0,0,0,6,20,0,0,20
8987,0,1,1,2,147,0.733333333333333,120,27
8988,0,0,4,0,601,3.66666666666667,601,0
8989,10,0,1,23,259,0.6,98,161
8990,0,2,2,0,262,1.6,262,0
8991,0,0,0,9,180,0,0,180
8992,0,0,0,11,31,0,0,31
8993,0,2,0,11,83,0,0,83
8994,0,3,0,11,185,0,0,185
8995,1,2,0,11,146,0,0,146
8996,0,0,3,0,221,1.35,221,0
8997,1,0,0,12,76,0,0,76
8998,5,5,0,8,132,0,0,132
8999,6,2,0,9,131,0,0,131
9000,1,0,0,13,76,0,0,76
9001,1,0,4,8,308,1.41666666666667,232,76
9002,0,0,0,5,79,0,0,79
9003,0,1,0,12,141,0,0,141
9004,2,3,0,10,149,0,0,149
9005,4,0,0,15,106,0,0,106
9006,1,0,0,14,89,0,0,89
9007,0,2,0,8,67,0,0,67
9008,0,0,2,0,292,1.78333333333333,292,0
9009,0,0,4,0,219,1.33333333333333,219,0
9010,0,0,0,5,26,0,0,26
9011,0,0,2,8,142,0.816666666666667,134,8
9012,1,3,0,8,104,0,0,104
9013,2,4,0,10,116,0,0,116
9014,1,0,3,7,186,1.08333333333333,178,8
9015,2,0,2,10,138,0.616666666666667,101,37
9016,0,0,5,0,435,2.65,435,0
9017,0,0,0,11,142,0,0,142
9018,1,0,1,8,153,0.416666666666667,68,85
9019,0,3,0,10,88,0,0,88
9020,1,3,0,5,90,0,0,90
9021,0,0,0,7,105,0,0,105
9022,0,0,0,10,128,0,0,128
9023,0,0,2,0,265,1.61666666666667,265,0
9024,0,0,3,3,228,1.08333333333333,178,50
9025,1,0,0,14,129,0,0,129
9026,0,2,0,12,170,0,0,170
9027,0,0,0,4,50,0,0,50
9028,22,0,1,23,382,0.6,98,284
9029,0,0,5,0,197,1.2,197,0
9030,1,2,0,13,112,0,0,112
9031,0,0,10,1,209,1.18333333333333,194,15
9032,13,0,1,17,136,0.216666666666667,36,100
9033,5,1,0,18,212,0,0,212
9034,0,1,9,2,399,2.31666666666667,381,18
9035,2,0,0,12,132,0,0,132
9037,0,2,0,10,125,0,0,125
9038,17,0,2,12,179,0.616666666666667,101,78
9039,0,0,0,1,6,0,0,6
9040,0,0,5,4,275,1.36666666666667,225,50
9041,2,2,0,9,138,0,0,138
9042,0,0,1,0,139,0.85,139,0
9043,1,5,0,12,183,0,0,183
9045,0,1,1,0,186,1.13333333333333,186,0
9046,1,0,0,1,15,0,0,15
9047,0,3,0,11,85,0,0,85
9048,2,2,0,6,74,0,0,74
9049,1,1,4,4,527,2.76666666666667,454,73
9050,3,0,0,16,237,0,0,237
9051,0,0,1,0,77,0.466666666666667,77,0
9052,0,0,0,7,93,0,0,93
9054,11,0,2,27,358,0.883333333333333,145,213
9055,6,0,0,18,113,0,0,113
9056,1,0,2,9,152,0.716666666666667,118,34
9057,4,0,1,15,53,0.0833333333333333,14,39
9058,8,0,1,10,141,0.216666666666667,36,105
9059,4,1,0,12,211,0,0,211
9060,0,0,1,10,142,0.616666666666667,101,41
9061,1,2,0,14,149,0,0,149
9063,0,0,0,10,173,0,0,173
9064,5,5,0,15,117,0,0,117
9065,1,0,0,6,131,0,0,131
9066,0,0,0,12,26,0,0,26
9068,0,5,0,14,197,0,0,197
9069,0,0,0,6,86,0,0,86
9070,0,0,1,0,224,1.36666666666667,224,0
9071,6,2,0,4,80,0,0,80
9073,0,0,0,9,73,0,0,73
9074,0,0,8,3,241,1.21666666666667,200,41
9075,0,0,4,0,246,1.5,246,0
9076,3,0,0,22,87,0,0,87
9077,0,0,0,13,76,0,0,76
9078,0,0,4,2,114,0.6,98,16
9079,5,0,0,13,137,0,0,137
9080,0,2,0,11,108,0,0,108
9081,0,0,5,0,227,1.38333333333333,227,0
9082,1,1,0,8,118,0,0,118
9083,5,0,0,15,123,0,0,123
9084,0,0,1,0,180,1.1,180,0
9085,9,0,1,22,357,0.383333333333333,63,294
9086,0,0,1,0,273,1.66666666666667,273,0
9087,8,1,0,14,93,0,0,93
9088,1,0,0,10,107,0,0,107
9089,4,0,0,20,120,0,0,120
9090,9,0,6,0,413,2.51666666666667,413,0
9091,0,0,1,0,257,1.56666666666667,257,0
9092,3,0,0,15,77,0,0,77
9093,0,0,1,6,163,0.633333333333333,104,59
9094,3,0,0,13,226,0,0,226
9095,0,4,0,12,169,0,0,169
9096,5,1,0,13,128,0,0,128
9097,14,0,1,21,381,0.633333333333333,104,277
9098,0,0,0,6,30,0,0,30
9099,0,0,0,7,52,0,0,52
9100,0,0,0,6,62,0,0,62
9101,4,0,0,16,233,0,0,233
9102,1,0,1,11,123,0.316666666666667,52,71
9103,0,0,0,18,112,0,0,112
9104,0,0,0,9,89,0,0,89
9105,5,0,0,16,105,0,0,105
9106,1,0,1,13,125,0.516666666666667,85,40
9107,6,5,0,8,119,0,0,119
9108,1,0,0,6,101,0,0,101
9109,0,0,5,0,607,3.7,607,0
9110,0,0,1,0,287,1.75,287,0
9111,0,0,4,0,232,1.41666666666667,232,0
9112,3,0,2,10,212,0.85,139,73
9113,1,3,0,9,149,0,0,149
9114,1,0,6,2,245,1.4,229,16
9115,0,3,0,10,123,0,0,123
9116,3,4,0,6,140,0,0,140
9117,0,2,0,11,71,0,0,71
9118,4,1,0,11,165,0,0,165
9119,0,0,0,8,108,0,0,108
9120,11,0,6,0,501,3.05,501,0
9121,2,0,4,6,319,1.53333333333333,251,68
9122,0,0,5,0,1006,6.13333333333333,1006,0
9123,3,4,0,10,112,0,0,112
9124,3,1,1,15,264,0.6,98,166
9125,4,0,0,8,74,0,0,74
9126,0,1,2,5,193,1.03333333333333,169,24
9128,1,0,1,1,86,0.5,82,4
9129,3,0,1,6,104,0.2,33,71
9150,0,0,3,0,306,1.86666666666667,306,0
9151,2,0,2,11,202,0.516666666666667,85,117
9152,0,0,16,0,1001,6.1,1001,0
9153,0,0,0,10,115,0,0,115
9154,0,0,12,0,191,1.16666666666667,191,0
9156,1,0,0,4,43,0,0,43
9157,0,0,0,3,5,0,0,5
9158,5,0,2,16,284,1.18333333333333,194,90
9159,0,0,1,2,58,0.333333333333333,55,3
9160,0,0,0,6,55,0,0,55
9161,5,1,0,15,105,0,0,105
9162,9,0,3,6,263,1.31666666666667,216,47
9163,6,1,5,0,413,2.51666666666667,413,0
9164,0,0,13,0,278,1.7,278,0
9165,0,0,0,10,57,0,0,57
9166,3,1,1,7,130,0.516666666666667,85,45
9167,1,0,0,10,16,0,0,16
9169,9,2,6,1,523,3.18333333333333,522,1
9170,1,0,1,11,123,0.55,90,33
9171,2,0,6,3,854,4.85,796,58
9172,0,0,11,0,323,1.96666666666667,323,0
9173,0,1,0,6,71,0,0,71
9174,8,0,5,0,328,2,328,0
9175,7,0,5,0,328,2,328,0
9176,13,0,3,14,415,1.73333333333333,284,131
9177,0,0,0,14,126,0,0,126
9178,0,0,2,0,147,0.9,147,0
9179,4,1,3,9,169,0.9,147,22
9180,3,0,3,9,290,1.31666666666667,216,74
9181,0,0,0,1,1,0,0,1
9182,1,2,0,5,45,0,0,45
9183,1,0,0,8,19,0,0,19
9184,5,0,4,9,418,1.85,303,115
9185,8,0,1,2,144,0.8,131,13
9186,0,0,1,1,64,0.383333333333333,63,1
9187,2,0,4,5,347,1.85,303,44
9188,7,2,0,14,185,0,0,185
9189,2,0,0,10,15,0,0,15
9192,0,0,7,0,550,3.35,550,0
9193,0,0,1,0,175,1.06666666666667,175,0
9194,2,2,0,13,181,0,0,181
9195,2,2,0,15,162,0,0,162
9196,0,0,10,0,205,1.25,205,0
9198,0,0,0,10,171,0,0,171
9199,3,4,0,8,104,0,0,104
9200,0,0,9,0,634,3.86666666666667,634,0
9201,0,1,0,9,113,0,0,113
9203,2,0,0,13,74,0,0,74
9204,0,0,0,7,121,0,0,121
9205,0,0,3,4,102,0.45,74,28
9206,0,0,5,0,293,1.78333333333333,293,0
9207,1,0,0,14,77,0,0,77
9208,9,0,5,1,364,2.2,361,3
9209,0,0,0,2,2,0,0,2
9210,0,1,3,0,156,0.95,156,0
9211,0,0,4,1,121,0.733333333333333,120,1
9212,3,3,0,7,94,0,0,94
9213,0,0,13,0,277,1.7,277,0
9214,0,3,0,7,43,0,0,43
9215,7,0,2,10,325,1.33333333333333,218,107
9216,0,1,5,4,696,4.08333333333333,670,26
9217,0,0,2,0,350,2.13333333333333,350,0
9218,0,0,2,7,124,0.716666666666667,117,7
9219,1,0,1,11,34,0.133333333333333,22,12
9220,1,0,3,11,130,0.716666666666667,117,13
9221,5,1,4,11,105,0.533333333333333,88,17
9222,1,0,0,11,91,0,0,91
9223,11,2,4,1,285,1.73333333333333,284,1
9224,0,0,1,0,36,0.216666666666667,36,0
9225,0,0,0,8,39,0,0,39
9226,0,1,6,5,453,2.55,418,35
9227,6,0,3,4,313,1.73333333333333,284,29
9228,1,0,1,11,111,0.516666666666667,85,26
9229,3,1,0,17,96,0,0,96
9230,3,3,2,10,307,1.28333333333333,211,96
9231,4,2,0,16,140,0,0,140
9232,0,0,0,10,187,0,0,187
9234,0,0,0,6,37,0,0,37
9235,0,1,0,5,36,0,0,36
9236,2,5,0,15,145,0,0,145
9237,0,0,0,9,49,0,0,49
9238,0,0,0,12,84,0,0,84
9239,6,0,4,8,275,1.16666666666667,191,84
9240,0,0,0,6,59,0,0,59
9241,0,0,3,0,284,1.73333333333333,284,0
9242,5,2,0,17,199,0,0,199
9243,0,0,0,8,145,0,0,145
9244,11,0,3,9,281,1.16666666666667,191,90
9245,6,6,0,16,171,0,0,171
9246,1,0,4,4,562,3.23333333333333,530,32
9247,2,0,0,15,106,0,0,106
9248,0,0,0,6,71,0,0,71
9249,0,1,0,11,121,0,0,121
9250,2,1,0,14,158,0,0,158
9251,0,0,11,0,164,1.01666666666667,164,0
9252,0,0,3,6,185,0.833333333333333,137,48
9253,7,0,3,6,211,1.05,172,39
9254,0,0,1,10,210,1.01666666666667,167,43
9255,0,4,0,9,52,0,0,52
9257,8,0,5,0,325,1.98333333333333,325,0
9258,0,0,7,0,612,3.73333333333333,612,0
9259,0,0,1,3,103,0.333333333333333,55,48
9260,0,0,0,6,109,0,0,109
9261,2,1,0,17,114,0,0,114
9263,9,0,7,0,439,2.66666666666667,439,0
9264,10,0,4,2,320,1.85,303,17
9265,0,0,8,0,746,4.55,746,0
9266,3,0,0,18,174,0,0,174
9267,0,0,9,0,661,4.03333333333333,661,0
9268,5,2,0,11,133,0,0,133
9269,1,0,3,10,189,1.08333333333333,178,11
9271,0,0,0,4,49,0,0,49
9272,11,0,5,7,346,1.88333333333333,308,38
9273,0,0,2,9,218,1.23333333333333,202,16
9274,0,0,0,8,105,0,0,105
9275,0,0,0,8,42,0,0,42
9276,9,0,2,3,169,0.916666666666667,150,19
9277,0,0,11,0,278,1.7,278,0
9278,0,0,10,0,344,2.1,344,0
9279,5,0,3,7,341,1.73333333333333,284,57
9280,0,0,0,7,68,0,0,68
9281,0,0,0,11,101,0,0,101
9282,1,0,0,9,179,0,0,179
9283,0,0,1,0,208,1.26666666666667,208,0
9284,0,1,3,12,318,1.05,172,146
9285,0,0,10,0,683,4.16666666666667,683,0
9286,0,0,0,5,41,0,0,41
9287,2,1,0,14,120,0,0,120
9288,0,0,1,3,40,0.1,16,24
9289,0,0,0,8,100,0,0,100
9290,1,0,2,11,149,0.6,98,51
9291,0,0,1,0,148,0.9,148,0
9292,1,0,0,7,163,0,0,163
9293,0,0,5,4,173,0.883333333333333,144,29
9294,3,0,0,17,164,0,0,164
9295,0,0,0,9,58,0,0,58
9296,2,1,0,12,96,0,0,96
9297,1,0,0,19,217,0,0,217
9298,1,0,0,3,43,0,0,43
9299,5,0,3,9,311,1.45,237,74
9300,1,0,2,8,137,0.633333333333333,103,34
9302,0,0,1,0,251,1.53333333333333,251,0
9303,0,1,0,12,108,0,0,108
9304,1,0,0,9,183,0,0,183
9305,0,0,5,0,344,2.1,344,0
9306,0,1,0,5,20,0,0,20
9307,6,0,1,13,176,0.566666666666667,93,83
9308,0,0,0,1,5,0,0,5
9309,0,4,0,10,48,0,0,48
9310,3,4,1,12,255,0.666666666666667,109,146
9311,0,0,0,8,34,0,0,34
9313,0,0,1,0,189,1.15,189,0
9314,0,0,7,0,601,3.66666666666667,601,0
9315,0,0,0,10,60,0,0,60
9316,0,0,0,10,63,0,0,63
9317,3,2,0,8,121,0,0,121
9318,0,1,0,6,82,0,0,82
9319,1,0,2,10,136,0.683333333333333,112,24
9320,0,0,5,0,290,1.76666666666667,290,0
9321,1,0,3,8,158,0.916666666666667,150,8
9322,10,0,3,2,286,1.73333333333333,284,2
9323,0,0,0,9,44,0,0,44
9324,0,0,11,0,288,1.76666666666667,288,0
9325,2,0,1,14,59,0.15,25,34
9326,0,0,1,0,112,0.683333333333333,112,0
9327,2,1,0,16,122,0,0,122
9328,2,1,0,11,200,0,0,200
9329,1,0,1,10,89,0.283333333333333,46,43
9330,1,2,0,11,70,0,0,70
9331,7,7,0,22,318,0,0,318
9332,1,1,0,8,100,0,0,100
9333,0,0,0,2,6,0,0,6
9334,5,0,4,8,356,1.85,303,53
9335,8,3,0,20,207,0,0,207
9336,0,0,1,0,191,1.16666666666667,191,0
9337,0,4,0,12,83,0,0,83
9338,4,3,0,5,82,0,0,82
9339,0,0,3,0,489,2.98333333333333,489,0
9340,0,0,8,0,634,3.86666666666667,634,0
9341,1,0,3,8,351,1.8,295,56
9343,0,0,1,9,157,0.9,148,9
9345,2,0,1,6,136,0.283333333333333,46,90
9346,0,0,7,0,642,3.91666666666667,642,0
9347,2,0,0,14,168,0,0,168
9348,0,0,1,0,180,1.1,180,0
9349,0,0,8,0,210,1.28333333333333,210,0
9350,1,2,1,10,48,0.183333333333333,30,18
9351,0,1,0,9,149,0,0,149
9352,0,0,4,0,185,1.13333333333333,185,0
9353,0,0,9,0,273,1.66666666666667,273,0
9354,0,0,12,0,217,1.33333333333333,217,0
9355,0,0,2,1,130,0.783333333333333,129,1
9356,3,3,0,11,147,0,0,147
9357,4,0,0,17,105,0,0,105
9358,2,0,0,21,188,0,0,188
9359,0,0,6,0,205,1.25,205,0
9360,1,0,3,8,193,0.866666666666667,143,50
9361,1,2,0,7,139,0,0,139
9362,2,0,3,8,115,0.65,106,9
9363,11,0,6,0,424,2.58333333333333,424,0
9364,2,0,1,13,273,0.733333333333333,120,153
9365,4,18,9,4,3742,22.8,3738,4
9368,0,0,6,0,511,3.11666666666667,511,0
9369,13,0,2,13,332,1.4,229,103
9370,0,0,6,0,421,2.56666666666667,421,0
9371,1,3,1,11,163,0.383333333333333,63,100
9372,0,0,1,0,238,1.45,238,0
9373,0,0,5,0,177,1.08333333333333,177,0
9374,0,0,0,9,96,0,0,96
9375,0,0,0,10,78,0,0,78
9376,0,0,0,5,41,0,0,41
9378,0,0,7,0,541,3.3,541,0
9379,1,0,0,20,203,0,0,203
9380,0,2,0,17,243,0,0,243
9381,6,5,0,19,215,0,0,215
9382,0,0,1,9,83,0.366666666666667,60,23
9383,6,2,0,17,148,0,0,148
9385,0,0,0,10,51,0,0,51
9386,0,3,0,8,20,0,0,20
9387,6,0,1,11,50,0.166666666666667,27,23
9388,0,0,0,8,99,0,0,99
9389,5,0,0,16,134,0,0,134
9390,0,0,4,0,347,2.11666666666667,347,0
9391,9,0,3,8,337,1.73333333333333,284,53
9392,2,1,0,5,67,0,0,67
9393,0,0,0,7,99,0,0,99
9394,0,1,0,4,21,0,0,21
9395,0,0,0,3,12,0,0,12
9396,5,0,0,19,156,0,0,156
9397,0,0,6,0,528,3.21666666666667,528,0
9398,0,0,0,7,79,0,0,79
9399,0,3,3,9,331,1.21666666666667,199,132
9400,4,7,0,17,129,0,0,129
9401,0,0,4,0,175,1.06666666666667,175,0
9402,0,0,0,7,63,0,0,63
9403,9,6,0,16,156,0,0,156
9404,0,0,0,5,17,0,0,17
9405,0,0,1,0,287,1.75,287,0
9406,0,0,4,0,141,0.866666666666667,141,0
9407,0,0,0,8,57,0,0,57
9408,0,0,2,1,135,0.816666666666667,134,1
9409,0,0,0,2,20,0,0,20
9410,0,0,6,0,323,1.96666666666667,323,0
9411,0,0,1,3,212,1.08333333333333,178,34
9412,2,2,1,8,267,0.966666666666667,159,108
9414,0,0,0,10,150,0,0,150
9416,0,0,2,0,82,0.5,82,0
9417,0,0,1,0,251,1.53333333333333,251,0
9418,0,0,1,0,290,1.76666666666667,290,0
9419,6,0,0,16,126,0,0,126
9420,0,0,3,0,140,0.85,140,0
9421,0,0,0,2,7,0,0,7
9422,0,1,0,5,65,0,0,65
9423,0,0,1,0,355,2.16666666666667,355,0
9424,0,0,7,0,522,3.18333333333333,522,0
9425,4,0,0,17,123,0,0,123
9426,3,2,0,19,181,0,0,181
9427,1,4,0,14,123,0,0,123
9428,2,2,0,18,180,0,0,180
9429,0,0,6,0,481,2.93333333333333,481,0
9430,0,1,0,19,145,0,0,145
9431,0,2,0,7,59,0,0,59
9432,3,0,0,17,200,0,0,200
9433,2,1,0,14,56,0,0,56
9434,0,5,0,4,32,0,0,32
9435,0,0,0,14,85,0,0,85
9436,0,0,6,2,439,2.61666666666667,429,10
9437,0,0,7,1,344,2.08333333333333,342,2
9438,0,0,0,8,51,0,0,51
9439,0,0,10,0,771,4.7,771,0
9440,0,0,1,11,124,0.216666666666667,36,88
9441,0,0,10,0,826,5.03333333333333,826,0
9442,0,0,0,7,73,0,0,73
9443,0,0,2,1,176,1.06666666666667,175,1
9444,21,0,3,10,368,1.8,295,73
9445,0,0,1,10,271,0.966666666666667,159,112
9446,0,0,1,9,110,0.333333333333333,55,55
9447,11,0,7,24,714,3.08333333333333,505,209
9448,1,2,0,6,23,0,0,23
9449,4,0,0,15,102,0,0,102
9450,12,0,2,5,233,1.33333333333333,218,15
9451,0,0,6,1,398,2.41666666666667,397,1
9452,0,0,4,0,312,1.9,312,0
9453,0,0,7,0,536,3.26666666666667,536,0
9454,1,0,0,15,88,0,0,88
9455,1,0,0,10,35,0,0,35
9456,0,1,1,6,331,1.41666666666667,232,99
9457,0,0,0,13,94,0,0,94
9458,1,1,0,19,150,0,0,150
9459,0,0,0,7,56,0,0,56
9460,0,0,9,0,730,4.45,730,0
9462,0,1,0,5,35,0,0,35
9463,0,0,8,3,438,2.6,427,11
9464,0,0,10,0,538,3.28333333333333,538,0
9465,0,0,0,7,65,0,0,65
9466,0,0,0,5,29,0,0,29
9467,3,1,2,13,434,1.7,278,156
9468,5,0,4,12,376,1.85,303,73
9469,1,0,0,8,85,0,0,85
9470,0,0,6,0,391,2.38333333333333,391,0
9471,0,0,0,1,9,0,0,9
9472,9,0,5,17,483,2.26666666666667,371,112
9473,3,1,0,15,204,0,0,204
9474,1,1,0,11,134,0,0,134
9475,12,0,2,4,154,0.8,131,23
9476,2,0,0,19,103,0,0,103
9477,0,0,0,10,99,0,0,99
9478,0,0,1,0,287,1.75,287,0
9479,0,0,4,0,235,1.43333333333333,235,0
9480,1,0,1,9,38,0.133333333333333,22,16
9481,0,0,2,0,137,0.833333333333333,137,0
9482,0,0,0,14,127,0,0,127
9483,2,4,0,11,57,0,0,57
9484,12,0,4,9,337,1.7,278,59
9485,0,0,3,0,232,1.41666666666667,232,0
9486,3,2,0,17,138,0,0,138
9487,3,1,0,17,109,0,0,109
9488,1,0,0,10,18,0,0,18
9489,0,0,3,0,112,0.683333333333333,112,0
9490,4,2,0,16,204,0,0,204
9491,1,0,1,9,42,0.2,33,9
9492,10,0,2,3,196,1.06666666666667,175,21
9493,0,0,0,8,123,0,0,123
9494,6,1,0,20,185,0,0,185
9495,0,1,0,7,42,0,0,42
9496,3,1,0,10,134,0,0,134
9497,12,0,2,5,228,1.33333333333333,218,10
9498,3,0,0,17,149,0,0,149
9499,0,0,0,1,1,0,0,1
9500,7,0,3,6,315,1.73333333333333,284,31
9501,14,0,1,6,160,0.8,131,29
9502,6,2,0,7,24,0,0,24
9503,0,1,0,4,29,0,0,29
9504,4,4,0,16,222,0,0,222
9505,0,0,3,0,164,1,164,0
9506,1,0,0,15,82,0,0,82
9507,4,0,0,16,88,0,0,88
9508,9,0,2,9,282,1.2,197,85
9509,0,0,3,0,191,1.16666666666667,191,0
9510,0,0,0,5,78,0,0,78
9511,7,1,0,5,59,0,0,59
9512,0,0,6,0,361,2.2,361,0
9514,6,0,2,9,157,0.65,106,51
9515,1,3,0,5,67,0,0,67
9516,1,0,0,4,29,0,0,29
9517,0,0,5,0,229,1.4,229,0
9518,0,0,0,5,58,0,0,58
9519,5,0,3,12,392,2,328,64
9520,0,0,0,6,116,0,0,116
9521,0,0,0,7,82,0,0,82
9522,0,0,0,10,91,0,0,91
9523,0,0,0,4,42,0,0,42
9524,3,3,0,12,112,0,0,112
9525,7,0,2,9,273,1.2,197,76
9526,0,1,0,3,15,0,0,15
9527,0,0,0,14,95,0,0,95
9528,0,0,0,4,26,0,0,26
9529,0,0,0,5,33,0,0,33
9530,0,0,1,0,268,1.63333333333333,268,0
9531,0,0,1,0,178,1.08333333333333,178,0
9533,0,0,9,0,812,4.95,812,0
9534,3,0,0,15,76,0,0,76
9535,1,0,1,11,78,0.116666666666667,19,59
9536,0,0,2,2,284,1.7,279,5
9537,0,0,0,8,84,0,0,84
9538,0,0,0,4,29,0,0,29
9541,0,0,6,0,347,2.11666666666667,347,0
9542,1,0,1,12,76,0.233333333333333,38,38
9543,16,0,1,4,103,0.6,98,5
9544,2,0,0,10,39,0,0,39
9545,5,1,0,19,158,0,0,158
9546,5,0,4,6,368,1.85,303,65
9547,7,0,4,2,315,1.9,311,4
9548,0,0,4,0,173,1.05,173,0
9549,0,0,1,0,112,0.683333333333333,112,0
9550,5,12,0,23,238,0,0,238
9551,4,4,0,17,192,0,0,192
9552,6,4,1,3,230,0.966666666666667,159,71
9553,0,0,6,0,492,3,492,0
9554,1,2,0,13,163,0,0,163
9555,0,0,0,4,60,0,0,60
9556,0,0,0,7,69,0,0,69
9558,0,1,0,4,26,0,0,26
9559,8,6,0,11,89,0,0,89
9560,2,4,0,12,152,0,0,152
9561,0,0,0,7,61,0,0,61
9678,0,0,0,19,185,0,0,185
9679,0,0,1,0,323,1.96666666666667,323,0
9681,0,0,2,0,282,1.71666666666667,282,0
9682,0,0,1,0,339,2.06666666666667,339,0
9683,8,0,4,11,408,2.33333333333333,382,26
9684,0,0,0,14,24,0,0,24
9685,2,2,0,15,174,0,0,174
9686,1,0,0,11,168,0,0,168
9687,0,0,0,14,75,0,0,75
9688,10,0,3,10,321,1.73333333333333,284,37
9689,0,1,0,5,41,0,0,41
9690,9,0,7,0,703,4.28333333333333,703,0
9691,1,0,0,2,52,0,0,52
9692,0,0,7,0,375,2.28333333333333,375,0
9693,2,0,0,16,129,0,0,129
9694,0,1,1,0,306,1.86666666666667,306,0
9695,7,0,0,22,179,0,0,179
9696,1,0,0,3,29,0,0,29
9697,2,0,0,11,115,0,0,115
9698,0,1,1,0,221,1.35,221,0
9699,10,0,1,4,133,0.6,98,35
9700,3,1,4,12,379,1.66666666666667,273,106
9701,0,0,0,11,77,0,0,77
9702,9,0,2,0,197,1.2,197,0
9703,12,0,1,4,161,0.8,131,30
9704,0,0,1,0,385,2.35,385,0
9705,1,0,0,16,114,0,0,114
9706,11,0,3,8,248,1.31666666666667,216,32
9707,4,0,0,17,247,0,0,247
9708,8,0,3,1,138,0.833333333333333,137,1
9709,0,0,1,0,355,2.16666666666667,355,0
9710,6,0,8,0,503,3.06666666666667,503,0
9711,1,0,2,9,211,0.6,98,113
9712,0,0,12,0,212,1.3,212,0
9713,12,0,3,8,327,1.73333333333333,284,43
9714,0,0,0,8,40,0,0,40
9715,0,1,0,5,53,0,0,53
9716,1,2,1,5,96,0.116666666666667,19,77
9717,2,2,4,4,296,1.5,245,51
9718,0,0,0,10,71,0,0,71
9719,1,0,0,10,210,0,0,210
9720,0,0,1,0,279,1.7,279,0
9721,0,0,1,0,235,1.43333333333333,235,0
9722,9,0,5,1,324,1.96666666666667,323,1
9723,1,0,1,9,85,0.3,49,36
9725,2,1,0,7,97,0,0,97
9726,0,0,0,8,46,0,0,46
9727,0,0,5,0,403,2.45,403,0
9728,2,1,0,15,50,0,0,50
9729,1,1,1,6,375,1.65,271,104
9730,3,0,2,11,143,0.7,115,28
9731,10,0,1,10,156,0.8,131,25
9732,7,0,2,9,163,0.65,106,57
9733,9,0,4,1,256,1.55,255,1
9735,0,0,0,11,104,0,0,104
9736,0,0,0,4,16,0,0,16
9737,10,0,2,7,287,1.4,229,58
9738,0,0,1,0,287,1.75,287,0
9739,1,2,7,3,333,2,328,5
9740,4,0,0,9,156,0,0,156
9741,9,0,3,6,319,1.73333333333333,284,35
9742,0,0,1,0,213,1.3,213,0
9743,2,0,1,9,42,0.2,33,9
9744,0,0,7,0,358,2.18333333333333,358,0
9745,2,0,2,10,182,0.633333333333333,104,78
9746,3,2,0,17,122,0,0,122
9747,0,0,0,14,119,0,0,119
9748,17,0,0,14,133,0,0,133
9749,0,0,0,8,32,0,0,32
9750,0,0,13,0,223,1.36666666666667,223,0
9751,2,0,2,10,150,0.416666666666667,68,82
9752,0,0,0,9,57,0,0,57
9753,0,0,0,1,4,0,0,4
9754,0,1,3,0,471,2.86666666666667,471,0
9755,0,1,0,3,4,0,0,4
9756,0,0,12,0,216,1.33333333333333,216,0
9757,11,0,0,12,190,0,0,190
9758,3,0,1,9,39,0.183333333333333,30,9
9759,0,0,1,10,44,0.15,25,19
9760,0,1,10,0,212,1.3,212,0
9761,4,2,1,8,106,0.116666666666667,19,87
9762,3,1,1,9,153,0.4,66,87
9763,8,0,3,15,370,1.5,246,124
9765,0,0,0,7,42,0,0,42
9766,3,5,0,11,103,0,0,103
9767,0,1,0,11,90,0,0,90
9768,0,0,2,7,77,0.4,65,12
9769,0,0,2,0,224,1.36666666666667,224,0
9770,1,0,1,10,66,0.3,49,17
9771,0,0,1,0,246,1.5,246,0
9772,4,3,0,5,71,0,0,71
9773,0,0,11,0,179,1.1,179,0
9774,9,0,1,10,66,0.266666666666667,44,22
9775,0,1,0,2,4,0,0,4
9776,6,0,4,13,431,2.06666666666667,339,92
9777,0,0,0,6,49,0,0,49
9778,0,0,10,0,152,0.933333333333333,152,0
9779,0,0,3,0,407,2.48333333333333,407,0
9780,8,0,4,12,399,1.85,303,96
9781,0,0,2,0,424,2.58333333333333,424,0
9782,8,0,3,8,291,1.45,237,54
9783,0,0,0,10,19,0,0,19
9784,11,0,1,5,171,0.8,131,40
9785,9,0,3,7,334,1.73333333333333,284,50
9786,0,0,7,0,406,2.48333333333333,406,0
9787,0,0,1,0,112,0.683333333333333,112,0
9788,0,0,1,0,328,2,328,0
9789,0,0,4,0,304,1.85,304,0
9790,1,0,2,9,85,0.366666666666667,61,24
9791,6,1,0,19,125,0,0,125
9792,0,0,0,10,71,0,0,71
9793,0,0,1,0,148,0.9,148,0
9794,0,0,4,0,188,1.15,188,0
9795,2,0,0,10,175,0,0,175
9797,0,0,0,5,39,0,0,39
9798,13,0,3,10,328,1.73333333333333,284,44
9799,0,0,2,0,216,1.31666666666667,216,0
9800,0,0,1,10,111,0.5,82,29
9801,2,0,0,13,31,0,0,31
9802,3,0,0,18,87,0,0,87
9803,7,0,7,1,877,5.33333333333333,876,1
9805,14,0,2,4,163,0.933333333333333,153,10
9806,0,0,0,15,87,0,0,87
9808,1,0,0,2,6,0,0,6
9809,0,0,0,10,65,0,0,65
9810,3,2,0,16,91,0,0,91
9811,0,0,0,16,96,0,0,96
9812,3,0,0,14,192,0,0,192
9813,0,0,3,4,184,1.05,172,12
9814,0,0,0,8,46,0,0,46
9815,0,0,1,0,210,1.28333333333333,210,0
9816,1,0,0,11,20,0,0,20
9817,10,2,0,20,107,0,0,107
9818,0,0,1,0,139,0.85,139,0
9819,8,0,6,1,222,1.35,221,1
9820,3,0,0,15,107,0,0,107
9821,0,0,3,0,221,1.35,221,0
9823,0,0,1,0,115,0.7,115,0
9824,0,0,1,0,238,1.45,238,0
9826,2,5,1,7,173,0.616666666666667,101,72
9827,0,0,1,0,169,1.03333333333333,169,0
9828,2,0,2,9,170,0.966666666666667,158,12
9829,1,0,0,11,209,0,0,209
9830,1,0,1,10,73,0.283333333333333,46,27
9831,4,2,0,16,195,0,0,195
9832,1,0,0,7,100,0,0,100
9833,0,0,0,11,68,0,0,68
9834,0,0,1,0,323,1.96666666666667,323,0
9835,2,7,0,11,96,0,0,96
9836,11,0,2,0,342,2.08333333333333,342,0
9837,0,0,0,2,10,0,0,10
9838,0,1,1,5,298,1.26666666666667,208,90
9839,0,0,0,11,79,0,0,79
9840,4,3,0,5,69,0,0,69
9841,10,0,1,7,194,0.8,131,63
9842,0,0,0,12,67,0,0,67
9843,2,0,0,15,98,0,0,98
9844,0,0,0,3,9,0,0,9
9845,0,0,0,3,9,0,0,9
9846,1,0,2,7,143,0.5,82,61
9847,0,0,13,0,260,1.58333333333333,260,0
9848,9,0,3,11,288,1.31666666666667,216,72
9849,0,0,4,0,133,0.816666666666667,133,0
9850,0,0,1,0,279,1.7,279,0
9851,1,0,0,11,61,0,0,61
9852,0,0,1,0,227,1.38333333333333,227,0
9853,1,0,0,14,75,0,0,75
9854,2,2,3,13,345,1.01666666666667,167,178
9855,13,0,5,8,450,2.45,401,49
9856,0,0,0,9,51,0,0,51
9857,4,0,0,18,208,0,0,208
9858,1,0,0,14,75,0,0,75
9859,11,0,6,0,337,2.05,337,0
9860,0,1,2,0,580,3.53333333333333,580,0
9861,1,0,0,16,169,0,0,169
9862,10,0,3,15,305,1.31666666666667,216,89
9863,2,0,0,17,95,0,0,95
9864,0,0,1,0,333,2.03333333333333,333,0
9943,0,0,1,0,82,0.5,82,0
9944,0,0,4,2,122,0.633333333333333,104,18
9946,1,3,5,9,479,2.56666666666667,421,58
9947,1,1,0,9,107,0,0,107
